Magyarországi Független Szocialista Parasztpárt	magyarországi független szocialista parasztpárt	47
Magyarországi Földmunkások Országos Szövetsége	magyarországi földmunkások országos szövetsége	46
Történelmi Épületcsoportot Alpár Ignác	történelmi épületcsoportot alpár ignác	38
Alsó-Magyarországon Esterházy Miklós	alsó-magyarországon esterházy miklós	36
Újjászervezett Szociáldemokrata Párt	újjászervezett szociáldemokrata párt	36
Magyarországi Szociáldemokrata Párt	magyarországi szociáldemokrata párt	35
Nemzetközi Szakszervezeti Szövetség	nemzetközi szakszervezeti szövetség	35
Constitutio Criminalis Carolinának	constitutio criminalis carolinának	34
Chlodwig Hohenlohe-Schillingsfürst	chlodwig hohenlohe-schillingsfürst	34
Nagy Egyenlőség Mennyei Birodalmát	nagy egyenlőség mennyei birodalmát	34
Nemzetőrség Központi Bizottságában	nemzetőrség központi bizottságában	34
Nemzetőrség Központi Bizottságának	nemzetőrség központi bizottságának	34
Németországi Szociáldemokrata Párt	németországi szociáldemokrata párt	34
Utazás Szentpétervárról Moszkvába	utazás szentpétervárról moszkvába	33
Munkáltatók Parlamenti Bizottsága	munkáltatók parlamenti bizottsága	33
Műemlékek Országos Bizottságának	műemlékek országos bizottságának	32
Felső-Magyarországi Fejedelemség	felső-magyarországi fejedelemség	32
Függetlenségi Országos Gazdapárt	függetlenségi országos gazdapárt	32
Juridisch-Politischer Leseverein	juridisch-politischer leseverein	32
Spanyolországtól Nyugat-Floridát	spanyolországtól nyugat-floridát	32
Zólyomi Dávidné Bethlen Katalin	zólyomi dávidné bethlen katalin	31
Igazságszolgáltatási Nagytanács	igazságszolgáltatási nagytanács	31
Alkotmány Barátainak Társasága	alkotmány barátainak társasága	30
Általános Német Munkásegyletet	általános német munkásegyletet	30
Eötvös Loránd Tudományegyetem	eötvös loránd tudományegyetem	29
Sobieski Jánost Lengyelország	sobieski jánost lengyelország	29
Újvilágot Amerigo Vespucciról	újvilágot amerigo vespucciról	29
Munkásképviseleti Bizottságot	munkásképviseleti bizottságot	29
Szociáldemokrata Munkáspártot	szociáldemokrata munkáspártot	29
Zágrábban Nemzeti Bizottságot	zágrábban nemzeti bizottságot	29
Természettudományi Múzeumban	természettudományi múzeumban	28
Birodalmi Udvari Kancellária	birodalmi udvari kancellária	28
Montecuccolitól Magyarország	montecuccolitól magyarország	28
Polgári Jogok Nyilatkozatára	polgári jogok nyilatkozatára	28
Amerikai Konföderált Államok	amerikai konföderált államok	28
Egyiptomot Nagy-Britanniának	egyiptomot nagy-britanniának	28
Társadalomtudományi Társaság	társadalomtudományi társaság	28
Magyar Mezőgazdasági Múzeum	magyar mezőgazdasági múzeum	27
Magyar Nemzeti Bizottságnak	magyar nemzeti bizottságnak	27
Nádasdi Gróf Nádasdy Ferenc	nádasdi gróf nádasdy ferenc	27
Függetlenségi Nyilatkozatot	függetlenségi nyilatkozatot	27
Függetlenségi Nyilatkozatra	függetlenségi nyilatkozatra	27
Németalföldet Bajorországra	németalföldet bajorországra	27
Demokrata-Republikánus Párt	demokrata-republikánus párt	27
Indiai Nemzeti Kongresszust	indiai nemzeti kongresszust	27
Nemzetközi Munkások Francia	nemzetközi munkások francia	27
Osztrák-Magyar Monarchiához	osztrák-magyar monarchiához	27
Polgári Jogok Nyilatkozatát	polgári jogok nyilatkozatát	27
Szláv Etnográfiai Kiállítás	szláv etnográfiai kiállítás	27
Törvényhatósági Tudósítások	törvényhatósági tudósítások	27
Újjászületésének Társaságát	újjászületésének társaságát	27
Magyar Nemzeti Igazgatóság	magyar nemzeti igazgatóság	26
Párizsban Kossuth Lajossal	párizsban kossuth lajossal	26
Délkelet-Ázsiától Európáig	délkelet-ázsiától európáig	26
Újszerzeményi Bizottságnak	újszerzeményi bizottságnak	26
Független Szocialista Párt	független szocialista párt	26
Konsztantyin Nyikolajevics	konsztantyin nyikolajevics	26
Magyar Nemzeti Igazgatóság	magyar nemzeti igazgatóság	26
Magyar Általános Hitelbank	magyar általános hitelbank	26
Munkások Északi Szövetsége	munkások északi szövetsége	26
Nemzetközi Afrika Társaság	nemzetközi afrika társaság	26
Polgári Jogok Nyilatkozata	polgári jogok nyilatkozata	26
Thesszáliát Görögországnak	thesszáliát görögországnak	26
Kristóf Geszthy Ferencnek	kristóf geszthy ferencnek	25
Természetesen Vajdahunyad	természetesen vajdahunyad	25
Amerikai Egyesült Államok	amerikai egyesült államok	25
Brandenburgi Fejedelemség	brandenburgi fejedelemség	25
Ernst Rüdiger Starhemberg	ernst rüdiger starhemberg	25
Amerikai Egyesült Államok	amerikai egyesült államok	25
Függetlenségi Nyilatkozat	függetlenségi nyilatkozat	25
Országgyűlési Tudósítások	országgyűlési tudósítások	25
Osztrák-Magyar Monarchián	osztrák-magyar monarchián	25
Osztrák-Magyar Monarchiát	osztrák-magyar monarchiát	25
Párizsba Teleki Lászlóhoz	párizsba teleki lászlóhoz	25
Drégelyből Szondi György	drégelyből szondi györgy	24
Gödöllői Királyi Kastély	gödöllői királyi kastély	24
Magyar Katonai Érdemrend	magyar katonai érdemrend	24
Miközben Antonio Caraffa	miközben antonio caraffa	24
Johann Caspar Ampringent	johann caspar ampringent	24
Magyarországon Ferdinánd	magyarországon ferdinánd	24
Mátyásnak Magyarországot	mátyásnak magyarországot	24
Ulrich Zwinglivel Luther	ulrich zwinglivel luther	24
Danton-Robespierre-Marat	danton-robespierre-marat	24
Délorosz Munkásszövetség	délorosz munkásszövetség	24
Felszabadítás Szövetsége	felszabadítás szövetsége	24
Hohenzollern-Sigmaringen	hohenzollern-sigmaringen	24
Istentisztelők Társasága	istentisztelők társasága	24
Kereskedelmi Társaságért	kereskedelmi társaságért	24
Osztrák-Magyar Monarchia	osztrák-magyar monarchia	24
Szécsent Esterházy Móric	szécsent esterházy móric	24
Temesben Dessewffy Antal	temesben dessewffy antal	24
Homonnai Drugeth György	homonnai drugeth györgy	23
Margitot Magyarországra	margitot magyarországra	23
Pápára Eszterházy Antal	pápára eszterházy antal	23
Barbarossa Hairaddinnek	barbarossa hairaddinnek	23
Birodalmi Udvari Tanács	birodalmi udvari tanács	23
Collegium Germanicummal	collegium germanicummal	23
Enea Silvio Piccolomini	enea silvio piccolomini	23
Törvényhozó Bizottságot	törvényhozó bizottságot	23
Arnold Toynbee Lectures	arnold toynbee lectures	23
Batáviai Köztársaságról	batáviai köztársaságról	23
Egyenlők Összeesküvését	egyenlők összeesküvését	23
Fülöp Franciaországában	fülöp franciaországában	23
Jean Jacques Dessalines	jean jacques dessalines	23
Mexikóban Benito Juarez	mexikóban benito juarez	23
Missourikompromisszumot	missourikompromisszumot	23
Munka Felszabadításának	munka felszabadításának	23
Mária Terézia Urbariuma	mária terézia urbariuma	23
Északnémet Szövetségnek	északnémet szövetségnek	23
Brandenburgi Katalinra	brandenburgi katalinra	22
Drégelypalánkot Rudolf	drégelypalánkot rudolf	22
Mikor Báthory Erzsébet	mikor báthory erzsébet	22
Valamikor Magyarország	valamikor magyarország	22
Franciaországot Európa	franciaországot európa	22
Kanizsai Főkapitányság	kanizsai főkapitányság	22
Livóniát Lengyelország	livóniát lengyelország	22
Magyarország Erdélyhez	magyarország erdélyhez	22
Osztrák-Németalföldhöz	osztrák-németalföldhöz	22
Peres Ügyek Tanácsának	peres ügyek tanácsának	22
Székely Dózsa Györgyöt	székely dózsa györgyöt	22
Egyesült Tartományokat	egyesült tartományokat	22
Forradalmi Törvényszék	forradalmi törvényszék	22
Független Munkáspártot	független munkáspártot	22
Kommunisták Szövetsége	kommunisták szövetsége	22
Maximilien Robespierre	maximilien robespierre	22
Nagyatádi Szabó István	nagyatádi szabó istván	22
Németalföldi Királyság	németalföldi királyság	22
Pierre-Joseph Proudhon	pierre-joseph proudhon	22
Reformátorok Társasága	reformátorok társasága	22
Szocialista Munkáspárt	szocialista munkáspárt	22
Venustiano Carranzának	venustiano carranzának	22
Általános Munkásegylet	általános munkásegylet	22
Északnémet Szövetséget	északnémet szövetséget	22
Ecsedi Báthory György	ecsedi báthory györgy	21
Görgeynek Nagyváradon	görgeynek nagyváradon	21
Magyarországon Mátyás	magyarországon mátyás	21
Nemeskéri Kiss Miklós	nemeskéri kiss miklós	21
Szondi Emlékbizottság	szondi emlékbizottság	21
Bethlent Magyarország	bethlent magyarország	21
Bocskait Magyarország	bocskait magyarország	21
Carolina Resolutióban	carolina resolutióban	21
Erdélyből Isztambulba	erdélyből isztambulba	21
Ferencet Bécsújhelyen	ferencet bécsújhelyen	21
Gianbattista Castaldo	gianbattista castaldo	21
Jean-Jacques Rousseau	jean-jacques rousseau	21
Kereskedelmi Társaság	kereskedelmi társaság	21
Kubából Hernán Cortés	kubából hernán cortés	21
Martin Luther Ágoston	martin luther ágoston	21
Martinuzzi Györgyként	martinuzzi györgyként	21
Osztrák-Németalföldet	osztrák-németalföldet	21
Pragmatica Sanctiónak	pragmatica sanctiónak	21
Péter Horvátországban	péter horvátországban	21
Péter Oroszországával	péter oroszországával	21
Raimondo Montecuccoli	raimondo montecuccoli	21
Toszkán Nagyhercegség	toszkán nagyhercegség	21
Udvari Kancelláriával	udvari kancelláriával	21
Alkotmányos Chartában	alkotmányos chartában	21
Habsburg-Hohenzollern	habsburg-hohenzollern	21
Henry Morton Stanleyt	henry morton stanleyt	21
Honvédelmi Bizottmány	honvédelmi bizottmány	21
Industrial Revolution	industrial revolution	21
Kelet-Közép-Európában	kelet-közép-európában	21
Louis-Auguste Blanqui	louis-auguste blanqui	21
Magyar Tudós Társaság	magyar tudós társaság	21
Nemzetközi Bírósághoz	nemzetközi bírósághoz	21
Pragmatica Sanctióban	pragmatica sanctióban	21
Pragmatica Sanctióból	pragmatica sanctióból	21
Római Köztársaságokat	római köztársaságokat	21
Szervezeti Szabályzat	szervezeti szabályzat	21
Szociáldemokrata Párt	szociáldemokrata párt	21
Transvaal Köztársaság	transvaal köztársaság	21
Dobónak Szamosújvárt	dobónak szamosújvárt	20
Erdélyi Fejedelemség	erdélyi fejedelemség	20
Fügedi Oláh Erzsébet	fügedi oláh erzsébet	20
Gróf Batthyány Lajos	gróf batthyány lajos	20
Guthi Országh Mihály	guthi országh mihály	20
Károlyi Zsuzsannának	károlyi zsuzsannának	20
Marco Antonio Canini	marco antonio canini	20
Nagylóci Őrtoronnyal	nagylóci őrtoronnyal	20
Váradon Kara Ibrahim	váradon kara ibrahim	20
Városliget Széchenyi	városliget széchenyi	20
Északkeleti-Kárpátok	északkeleti-kárpátok	20
Alberoninak Szicília	alberoninak szicília	20
Alsó-Magyarországról	alsó-magyarországról	20
Asztrahányi Kánságot	asztrahányi kánságot	20
Brandenburgi Katalin	brandenburgi katalin	20
Collegium Hungaricum	collegium hungaricum	20
Egyesült Tartományok	egyesült tartományok	20
Felső-Magyarországon	felső-magyarországon	20
Francisco Pizarrónak	francisco pizarrónak	20
Georges-Louis Buffon	georges-louis buffon	20
Habsburgok Európában	habsburgok európában	20
Habsburgok Szatmáron	habsburgok szatmáron	20
Hondurastól Panamáig	hondurastól panamáig	20
Horvát Főkapitányság	horvát főkapitányság	20
Kardtestvérek Rendje	kardtestvérek rendje	20
Kelet-Poroszországot	kelet-poroszországot	20
Lelkiismereti Tanács	lelkiismereti tanács	20
Méliusz Juhász Péter	méliusz juhász péter	20
Bosznia-Hercegovinát	bosznia-hercegovinát	20
Egyenlőség Társasága	egyenlőség társasága	20
Florence Nightingale	florence nightingale	20
Honvédelmi Egyesület	honvédelmi egyesület	20
Horvát-Szlavónország	horvát-szlavónország	20
Ioan Alexandru Cuzát	ioan alexandru cuzát	20
Karolina Augusztának	karolina augusztának	20
Kommunista Kiáltvány	kommunista kiáltvány	20
Köztársasági Blokkot	köztársasági blokkot	20
Külföldi Tudósítások	külföldi tudósítások	20
Libériai Köztársaság	libériai köztársaság	20
Marsalában Garibaldi	marsalában garibaldi	20
Mihail Kogalniceanut	mihail kogalniceanut	20
Oroszországot Európa	oroszországot európa	20
Szerb Radikális Párt	szerb radikális párt	20
Tartományi Szövetség	tartományi szövetség	20
Trade Union Congress	trade union congress	20
Törvényhozó Gyűlésbe	törvényhozó gyűlésbe	20
Törvényhozó Testület	törvényhozó testület	20
Varsói Nagyhercegség	varsói nagyhercegség	20
Velencei Köztársaság	velencei köztársaság	20
Általános Munkáspárt	általános munkáspárt	20
Brankovics Györgyöt	brankovics györgyöt	19
Ferdinand Hardegget	ferdinand hardegget	19
Franz Liechtenstein	franz liechtenstein	19
Gesta Hungarorumban	gesta hungarorumban	19
Géza Egri Csillagok	géza egri csillagok	19
Kompolthy Miklósnak	kompolthy miklósnak	19
Kralovánszky László	kralovánszky lászló	19
Luxemburgi Zsigmond	luxemburgi zsigmond	19
Nyugat-Szlovákiában	nyugat-szlovákiában	19
Stiljanovics István	stiljanovics istván	19
Strattmann Eleonóra	strattmann eleonóra	19
Szelepcsényi György	szelepcsényi györgy	19
Szondinak Drégelyen	szondinak drégelyen	19
Temesvártól Zenggig	temesvártól zenggig	19
Trencséni Csák Máté	trencséni csák máté	19
Visszatérve Svájcba	visszatérve svájcba	19
Angliának Európában	angliának európában	19
Barsszentkeresztnél	barsszentkeresztnél	19
Brandenburgi Albert	brandenburgi albert	19
Cornelius Jansenius	cornelius jansenius	19
Diploma Leopoldinum	diploma leopoldinum	19
Hollandia Európában	hollandia európában	19
Joachim Winckelmann	joachim winckelmann	19
Kalandos Társaságot	kalandos társaságot	19
Lotharingiai Ferenc	lotharingiai ferenc	19
Lotharingiai Károly	lotharingiai károly	19
Moszkvai Társaságot	moszkvai társaságot	19
Nagy-Britanniájánál	nagy-britanniájánál	19
Nyugat-Poroszország	nyugat-poroszország	19
Pragmatica Sanctiót	pragmatica sanctiót	19
Szelepcsényi György	szelepcsényi györgy	19
Tridenti Hitvallást	tridenti hitvallást	19
Észak-Franciaország	észak-franciaország	19
Alkotmányozó Gyűlés	alkotmányozó gyűlés	19
Antiszemita Pártban	antiszemita pártban	19
Balkánon Thesszália	balkánon thesszália	19
Bethmann-Hollwegnek	bethmann-hollwegnek	19
Bolgár Fejedelemség	bolgár fejedelemség	19
Bosznia-Hercegovina	bosznia-hercegovina	19
Constantin Bratianu	constantin bratianu	19
Délnyugat-Afrikában	délnyugat-afrikában	19
Felix Schwarzenberg	felix schwarzenberg	19
Fiatal Magyarország	fiatal magyarország	19
Gladstonekabinetnek	gladstonekabinetnek	19
Hazafiak Szövetsége	hazafiak szövetsége	19
Holsteinét Ausztria	holsteinét ausztria	19
Horvát Nemzeti Párt	horvát nemzeti párt	19
Hármasság Társasága	hármasság társasága	19
Közjóléti Bizottság	közjóléti bizottság	19
Nemválasztók Pártja	nemválasztók pártja	19
Obrenovicot Szerbia	obrenovicot szerbia	19
Oranje Szabad Állam	oranje szabad állam	19
Pragmatica Sanctiót	pragmatica sanctiót	19
Rajnai Szövetséghez	rajnai szövetséghez	19
Össznémet Szövetség	össznémet szövetség	19
Alexander Bixiónak	alexander bixiónak	18
Bajnai Both András	bajnai both andrás	18
Balthasar Simunich	balthasar simunich	18
Bekefalvay Gergely	bekefalvay gergely	18
Berneczki Katarina	berneczki katarina	18
Boldogságos Szűzet	boldogságos szűzet	18
Felső-Magyarország	felső-magyarország	18
Honvéd Kincstárnak	honvéd kincstárnak	18
Jérome Napoléonnak	jérome napoléonnak	18
Komárom-Esztergomi	komárom-esztergomi	18
Konstantinápolyból	konstantinápolyból	18
Losonczi Albertnek	losonczi albertnek	18
Pallavicini Sforza	pallavicini sforza	18
Pietro Ferraboscót	pietro ferraboscót	18
Pozsegától Békésig	pozsegától békésig	18
Sanyiki Krisztinát	sanyiki krisztinát	18
Segítséget Drégely	segítséget drégely	18
Tiefenbach Kristóf	tiefenbach kristóf	18
Alessandro Farnese	alessandro farnese	18
Aragóniai Katalint	aragóniai katalint	18
Bogdan Hmelnyickij	bogdan hmelnyickij	18
Felső-Magyarország	felső-magyarország	18
Felvidéken Caraffa	felvidéken caraffa	18
Ferdinándot Mátyás	ferdinándot mátyás	18
George Washingtont	george washingtont	18
Inkvizíció Tanácsa	inkvizíció tanácsa	18
Jogok Nyilatkozata	jogok nyilatkozata	18
Kelet-Magyarország	kelet-magyarország	18
Konstantinápolyból	konstantinápolyból	18
Kurlandi Hercegség	kurlandi hercegség	18
Közép-Magyarország	közép-magyarország	18
Livóniai Lovagrend	livóniai lovagrend	18
Nyugat-Anatóliában	nyugat-anatóliában	18
Pragmatica Sanctio	pragmatica sanctio	18
Richard Chancellor	richard chancellor	18
Roberto Bellarmino	roberto bellarmino	18
Rotterdami Erasmus	rotterdami erasmus	18
Titkos Konferencia	titkos konferencia	18
Udvari Kancellária	udvari kancellária	18
Alkotmányos Charta	alkotmányos charta	18
Belgrádtól Ruszéig	belgrádtól ruszéig	18
Berzeviczy Gergely	berzeviczy gergely	18
Bourbonrestauráció	bourbonrestauráció	18
Békét Teremtő Ököl	békét teremtő ököl	18
Böszörményi László	böszörményi lászló	18
Csehszlovák Egység	csehszlovák egység	18
David Lloyd George	david lloyd george	18
Dessewffy Auréllal	dessewffy auréllal	18
Egyesült Izzólámpa	egyesült izzólámpa	18
Elzász-Lotaringiát	elzász-lotaringiát	18
Emmeline Pankhurst	emmeline pankhurst	18
Ferdinand Lassalle	ferdinand lassalle	18
Festetics Julianna	festetics julianna	18
Függetlenségi Párt	függetlenségi párt	18
Georges Clemenceau	georges clemenceau	18
Haza Szövetségének	haza szövetségének	18
Hohenzollern Lipót	hohenzollern lipót	18
Hétszemélyes Tábla	hétszemélyes tábla	18
Hódmezővásárhelyen	hódmezővásárhelyen	18
Ibériaifélszigeten	ibériaifélszigeten	18
Joseph Chamberlain	joseph chamberlain	18
Józseffel Ausztria	józseffel ausztria	18
Mannheimer Zeitung	mannheimer zeitung	18
Mérsékelt Ellenzék	mérsékelt ellenzék	18
Nemzet Római Szent	nemzet római szent	18
Nicolas Chauvinről	nicolas chauvinről	18
Oranje Szabadállam	oranje szabadállam	18
Osztrák Császárság	osztrák császárság	18
Pragmatica Sanctio	pragmatica sanctio	18
Rajnai Szövetséget	rajnai szövetséget	18
Szentkirályi Móric	szentkirályi móric	18
Szolártsik Sándort	szolártsik sándort	18
Theodore Roosevelt	theodore roosevelt	18
Tudor Vladimirescu	tudor vladimirescu	18
Wagramnál Napóleon	wagramnál napóleon	18
Wilhelm Liebknecht	wilhelm liebknecht	18
Ócsai Balogh Péter	ócsai balogh péter	18
FRANCIA FORRADALOM	francia forradalom	18
Balaton-Drávaközi	balaton-drávaközi	17
Beckensloer János	beckensloer jános	17
Bernardo Gabellio	bernardo gabellio	17
Brakonvics György	brakonvics györgy	17
Kanizsay Dorottya	kanizsay dorottya	17
Konstantinápolyba	konstantinápolyba	17
Korjatovics Tódor	korjatovics tódor	17
Károlyi Zsuzsanna	károlyi zsuzsanna	17
Majláth Istvánnal	majláth istvánnal	17
Marquis Chasteler	marquis chasteler	17
Mágócsi Gáspárnak	mágócsi gáspárnak	17
Ottavio Baldigara	ottavio baldigara	17
Pietro Ferrabosco	pietro ferrabosco	17
Sigér Dorottyával	sigér dorottyával	17
Udvari Haditanács	udvari haditanács	17
Vajdahunyadvárról	vajdahunyadvárról	17
Valahol Európában	valahol európában	17
Wesselényi Ferenc	wesselényi ferenc	17
Benjamin Franklin	benjamin franklin	17
Benvenuto Cellini	benvenuto cellini	17
Borisz Godunovnak	borisz godunovnak	17
Délkelet-Ázsiában	délkelet-ázsiában	17
Dévai Bíró Mátyás	dévai bíró mátyás	17
Felső-Ausztriában	felső-ausztriában	17
Franciaországának	franciaországának	17
General Statennel	general statennel	17
Gusztáv Adolféhoz	gusztáv adolféhoz	17
Hieronymus Laskit	hieronymus laskit	17
Katolikus Ligával	katolikus ligával	17
Louis Montesquieu	louis montesquieu	17
Magas Bizottságot	magas bizottságot	17
Minamoto Joritomo	minamoto joritomo	17
Nagy-Britanniából	nagy-britanniából	17
Nagy-Britanniához	nagy-britanniához	17
Nagy-Britanniának	nagy-britanniának	17
Pénzügyek Tanácsa	pénzügyek tanácsa	17
Ratio Educationis	ratio educationis	17
Szamosközy István	szamosközy istván	17
Székesfehérvárott	székesfehérvárott	17
Tadeus Kosciuszko	tadeus kosciuszko	17
Thomas Cranmertől	thomas cranmertől	17
Timurida Báburhoz	timurida báburhoz	17
Utrechti Adorjánt	utrechti adorjánt	17
Vatikáni Könyvtár	vatikáni könyvtár	17
Államkancelláriát	államkancelláriát	17
Észak-Kaukázusban	észak-kaukázusban	17
Andrássy Gyulának	andrássy gyulának	17
Battenberg Sándor	battenberg sándor	17
Benjamin Disraeli	benjamin disraeli	17
Dunai Szövetséget	dunai szövetséget	17
Egyenlítői-Afrika	egyenlítői-afrika	17
Elzász-Lotaringia	elzász-lotaringia	17
Erdélyben Puchner	erdélyben puchner	17
Ferdinand Lesseps	ferdinand lesseps	17
Frantisek Palacky	frantisek palacky	17
Giovanni Giolitti	giovanni giolitti	17
Henrik Dembinskit	henrik dembinskit	17
Horváth Boldizsár	horváth boldizsár	17
Joszip Jelasicsot	joszip jelasicsot	17
Karadjordjevicsok	karadjordjevicsok	17
Kelet-Anatóliában	kelet-anatóliában	17
Kereskedelmi Bank	kereskedelmi bank	17
Kínai Köztársaság	kínai köztársaság	17
Liaotungfélsziget	liaotungfélsziget	17
Nagy-Britanniában	nagy-britanniában	17
Nagy-Britanniához	nagy-britanniához	17
Nagy-Britanniával	nagy-britanniával	17
Nathan Rothschild	nathan rothschild	17
Nemzeti Egyesület	nemzeti egyesület	17
Oszmán Birodalmat	oszmán birodalmat	17
Pobjedonoszcevnek	pobjedonoszcevnek	17
Republikánus Párt	republikánus párt	17
Római Köztársaság	római köztársaság	17
Shultze-Delitzsch	shultze-delitzsch	17
Szövetségi Gyűlés	szövetségi gyűlés	17
Szövetségi Tanács	szövetségi tanács	17
Sátoraljaújhelyen	sátoraljaújhelyen	17
Victoriano Huerta	victoriano huerta	17
Végrehajtó Tanács	végrehajtó tanács	17
William Gladstone	william gladstone	17
Ötszázak Tanácsát	ötszázak tanácsát	17
Balassa Jánossal	balassa jánossal	16
Béri Balogh Ádám	béri balogh ádám	16
Csehszlovákiához	csehszlovákiához	16
Domoszlai Miklós	domoszlai miklós	16
Drégelypalánkról	drégelypalánkról	16
Fráter Györggyel	fráter györggyel	16
Georg Paradeiser	georg paradeiser	16
Ilonát Zsuzsanna	ilonát zsuzsanna	16
Kompoltiné Ilona	kompoltiné ilona	16
Károlyi Györgyné	károlyi györgyné	16
Lantos Sebestyén	lantos sebestyén	16
Lengyelországból	lengyelországból	16
Lengyelországgal	lengyelországgal	16
Magyar Királyság	magyar királyság	16
Magyar Televízió	magyar televízió	16
Ocskay Lászlóval	ocskay lászlóval	16
Oszmán Birodalom	oszmán birodalom	16
Paolo Mirandolát	paolo mirandolát	16
Petrovics András	petrovics andrás	16
Pietro Ferabosco	pietro ferabosco	16
Pogány Franciska	pogány franciska	16
Sajószentpéteren	sajószentpéteren	16
Szentes Dorottya	szentes dorottya	16
Szécsényi László	szécsényi lászló	16
Wolfgang Puchaim	wolfgang puchaim	16
Ahmed Érsekújvár	ahmed érsekújvár	16
Aquinói Tamásnál	aquinói tamásnál	16
Batthyány Ferenc	batthyány ferenc	16
Borisz Godunovot	borisz godunovot	16
Bornemissza Anna	bornemissza anna	16
Báthori Zsigmond	báthori zsigmond	16
Béri Balogh Ádám	béri balogh ádám	16
Cateau-Cambrésis	cateau-cambrésis	16
Charlotte-Amalie	charlotte-amalie	16
Egyesült Államok	egyesült államok	16
Farnese Erzsébet	farnese erzsébet	16
Fejedelmi Tanács	fejedelmi tanács	16
Franciaországtól	franciaországtól	16
Gyulafehérvárott	gyulafehérvárott	16
Kalikutnál India	kalikutnál india	16
Lantos Sebestyén	lantos sebestyén	16
Legfelső Bíróság	legfelső bíróság	16
Maria Antoinette	maria antoinette	16
Marie Antoinette	marie antoinette	16
Mezőkeresztesnél	mezőkeresztesnél	16
Mihail Romanovot	mihail romanovot	16
Nyugat-Afrikában	nyugat-afrikában	16
Nyugat-Indiákkal	nyugat-indiákkal	16
Oszmán Birodalom	oszmán birodalom	16
Peloponnészoszon	peloponnészoszon	16
Pármai Izabellát	pármai izabellát	16
Rajnai Szövetség	rajnai szövetség	16
Rómában Leonardo	rómában leonardo	16
Saint-Germainben	saint-germainben	16
Siegbert Heister	siegbert heister	16
Szent Koronájára	szent koronájára	16
Szokolu Musztafa	szokolu musztafa	16
Székesfehérvárra	székesfehérvárra	16
Tengerész Henrik	tengerész henrik	16
Thomas Jefferson	thomas jefferson	16
Tokugava Iejaszu	tokugava iejaszu	16
Török Birodalmat	török birodalmat	16
Őrült Johannának	őrült johannának	16
Action Francaise	action francaise	16
Agustín Iturbide	agustín iturbide	16
Alsó-Ausztriában	alsó-ausztriában	16
Ballhausplatznak	ballhausplatznak	16
Birodalmi Gyűlés	birodalmi gyűlés	16
Birodalmi Tanács	birodalmi tanács	16
Csizmadia Sándor	csizmadia sándor	16
Dessewffy József	dessewffy józsef	16
Eduard Bernstein	eduard bernstein	16
Egyesült Államok	egyesült államok	16
Emiliano Zapatát	emiliano zapatát	16
Európaellenesség	európaellenesség	16
Festetics György	festetics györgy	16
Francesco Crispi	francesco crispi	16
Föderalista Párt	föderalista párt	16
Giuseppe Mazzini	giuseppe mazzini	16
Ifjú Olaszország	ifjú olaszország	16
Karibiszigeteken	karibiszigeteken	16
Kelet-Ruméliában	kelet-ruméliában	16
Kristóffy József	kristóffy józsef	16
Laczkovics János	laczkovics jános	16
Latin-Amerikában	latin-amerikában	16
Liszt Koronázási	liszt koronázási	16
Lord Castlereagh	lord castlereagh	16
Ludwig Feuerbach	ludwig feuerbach	16
Magyarországénál	magyarországénál	16
Marie Antoinette	marie antoinette	16
Márk Köztársaság	márk köztársaság	16
Nagy-Britanniára	nagy-britanniára	16
Nagy-Kolumbiához	nagy-kolumbiához	16
Nedeczky Istvánt	nedeczky istvánt	16
Nedeczkyküldetés	nedeczkyküldetés	16
Nyilatkozatukban	nyilatkozatukban	16
Októberi Diploma	októberi diploma	16
Oszmán Birodalom	oszmán birodalom	16
Peloponnészoszra	peloponnészoszra	16
Philiké Hetairia	philiké hetairia	16
Poroszországként	poroszországként	16
Raymond Poincaré	raymond poincaré	16
Szemere Bertalan	szemere bertalan	16
Szerb Vajdaságot	szerb vajdaságot	16
Széchényi Ferenc	széchényi ferenc	16
Szövetséges Liga	szövetséges liga	16
Ötszázak Tanácsa	ötszázak tanácsa	16
Banque Générale	banque générale	15
Bonyódi Demeter	bonyódi demeter	15
Béri Balog Ádám	béri balog ádám	15
Credit Mobilier	credit mobilier	15
Erasmus Teuffel	erasmus teuffel	15
Fényes Portánál	fényes portánál	15
Földváry Mihály	földváry mihály	15
Giacomo Durando	giacomo durando	15
Gibraltárjaként	gibraltárjaként	15
Görgey Artúrnak	görgey artúrnak	15
Horváth Annának	horváth annának	15
Horváth Annával	horváth annával	15
Jakosits Ferenc	jakosits ferenc	15
Kompolthy Imrét	kompolthy imrét	15
Komáromy György	komáromy györgy	15
Kőmíves Kelemen	kőmíves kelemen	15
Lengyelországba	lengyelországba	15
Losonczy Albert	losonczy albert	15
Losonczy István	losonczy istván	15
Magyarországról	magyarországról	15
Majtényi István	majtényi istván	15
Mecséry Gusztáv	mecséry gusztáv	15
Menti Múzeumban	menti múzeumban	15
Mikszáth Kálmán	mikszáth kálmán	15
Ocskay Erzsébet	ocskay erzsébet	15
Pietro Terbosco	pietro terbosco	15
Római Birodalom	római birodalom	15
Szakközépiskola	szakközépiskola	15
Szalánczy János	szalánczy jános	15
Szokollu Mehmed	szokollu mehmed	15
Széchy Máriához	széchy máriához	15
Szécsényi Marót	szécsényi marót	15
Szécsényi Tamás	szécsényi tamás	15
Viktor Emánuelt	viktor emánuelt	15
Zondy Györgytől	zondy györgytől	15
Alsó-Ausztriába	alsó-ausztriába	15
Andrea Doriának	andrea doriának	15
Antikrisztusnak	antikrisztusnak	15
Antimachiavelli	antimachiavelli	15
Batthyány Lajos	batthyány lajos	15
Besztercebányán	besztercebányán	15
Contrataciónnak	contrataciónnak	15
Enciklopédiának	enciklopédiának	15
Felső-Ausztriát	felső-ausztriát	15
Franciaországra	franciaországra	15
Franciaországét	franciaországét	15
Giovanni Medici	giovanni medici	15
Giuliano Rovere	giuliano rovere	15
Gyulafehérvárra	gyulafehérvárra	15
Helytartótanács	helytartótanács	15
Jurisics Miklós	jurisics miklós	15
Kamarai Bíróság	kamarai bíróság	15
Kelet-Európában	kelet-európában	15
Kollonich Lipót	kollonich lipót	15
Lodovico Gritti	lodovico gritti	15
Losonczy István	losonczy istván	15
Magyarországgal	magyarországgal	15
Magyarországról	magyarországról	15
Magyarországtól	magyarországtól	15
Marston Moornál	marston moornál	15
Mihail Viteazul	mihail viteazul	15
Mogul Birodalom	mogul birodalom	15
Nagy-Britanniát	nagy-britanniát	15
Nyugat-Európába	nyugat-európába	15
Oliver Cromwell	oliver cromwell	15
Peloponnészoszt	peloponnészoszt	15
Philadelphiában	philadelphiában	15
Philadelphiával	philadelphiával	15
Protestáns Unió	protestáns unió	15
Pénzügyi Tanács	pénzügyi tanács	15
Robert Devereux	robert devereux	15
Schmalkaldenben	schmalkaldenben	15
Szegedinác Péró	szegedinác péró	15
Szepesi Kamarát	szepesi kamarát	15
Tessedik Sámuel	tessedik sámuel	15
Thomas Cromwell	thomas cromwell	15
Télemakhoszában	télemakhoszában	15
Török Birodalom	török birodalom	15
William Tyndale	william tyndale	15
École Militaire	école militaire	15
Észak-Amerikába	észak-amerikába	15
Észak-Amerikára	észak-amerikára	15
Észak-Itáliában	észak-itáliában	15
Akadémiai Légió	akadémiai légió	15
Andrássy Gyulát	andrássy gyulát	15
Andrássy György	andrássy györgy	15
Ballhausplatzon	ballhausplatzon	15
Balásházy János	balásházy jános	15
Charles Boykott	charles boykott	15
Charles Fourier	charles fourier	15
Chrystal Palace	chrystal palace	15
Ciszlajtániában	ciszlajtániában	15
Cordeliers Klub	cordeliers klub	15
Crédit Mobilier	crédit mobilier	15
Csernyisevszkij	csernyisevszkij	15
Daily Telegraph	daily telegraph	15
Deákot Andrássy	deákot andrássy	15
Dumitru Sturdza	dumitru sturdza	15
Emiliano Zapata	emiliano zapata	15
Fejérváry Gézát	fejérváry gézát	15
Flottaegyesület	flottaegyesület	15
Georgiu Baritiu	georgiu baritiu	15
Hajnóczy József	hajnóczy józsef	15
Határozati Párt	határozati párt	15
Huertadiktatúra	huertadiktatúra	15
Huszadik Század	huszadik század	15
Jean-Paul Marat	jean-paul marat	15
Jefferson Davis	jefferson davis	15
Kelet-Európában	kelet-európában	15
Kempelen Farkas	kempelen farkas	15
Kemény Zsigmond	kemény zsigmond	15
Khuen-Héderváry	khuen-héderváry	15
Komáromtól Buda	komáromtól buda	15
Konstantinápoly	konstantinápoly	15
Közép-Európában	közép-európában	15
Legfelsőbb Lény	legfelsőbb lény	15
Lord Palmerston	lord palmerston	15
Lónyai Menyhért	lónyai menyhért	15
Madarász József	madarász józsef	15
Madarász László	madarász lászló	15
Magyar Újságban	magyar újságban	15
Magyarországnak	magyarországnak	15
Magyarországról	magyarországról	15
Magyarországtól	magyarországtól	15
Majna-Frankfurt	majna-frankfurt	15
Milos Obrenovic	milos obrenovic	15
Moltke Sedannál	moltke sedannál	15
Mária Krisztina	mária krisztina	15
Noszlopy Gáspár	noszlopy gáspár	15
Nyugat-Európába	nyugat-európába	15
Olasz Királyság	olasz királyság	15
Pancho Villának	pancho villának	15
Parlamenti Párt	parlamenti párt	15
Peloponnészoszt	peloponnészoszt	15
Philipp Stadion	philipp stadion	15
Poroszországnak	poroszországnak	15
Puchnert Szeben	puchnert szeben	15
Román Királyság	román királyság	15
Rudyard Kipling	rudyard kipling	15
Solymosi Eszter	solymosi eszter	15
Spanyol-Amerika	spanyol-amerika	15
Stewart Parnell	stewart parnell	15
Szárd Királyság	szárd királyság	15
Szőgyény László	szőgyény lászló	15
Temesi Bánságot	temesi bánságot	15
Táncsics Mihály	táncsics mihály	15
Török Birodalom	török birodalom	15
Verseghy Ferenc	verseghy ferenc	15
Várkonyi István	várkonyi istván	15
Észak-Afrikában	észak-afrikában	15
Észak-Amerikába	észak-amerikába	15
Észak-Itáliában	észak-itáliában	15
Északkelet-Kína	északkelet-kína	15
Balassagyarmat	balassagyarmat	14
Berczely János	berczely jános	14
Bikly Tamástól	bikly tamástól	14
Daniel Speckle	daniel speckle	14
Egyházas-Nánát	egyházas-nánát	14
Forgách Ferenc	forgách ferenc	14
Garai Jánosnak	garai jánosnak	14
Giovanni Doria	giovanni doria	14
Harkálypusztán	harkálypusztán	14
Hegedűs István	hegedűs istván	14
Helmeczy János	helmeczy jános	14
Kapitán György	kapitán györgy	14
Kazinczy Lajos	kazinczy lajos	14
Kompolthy Imre	kompolthy imre	14
Kompolthyakkal	kompolthyakkal	14
Képzeletünkben	képzeletünkben	14
Magyarországot	magyarországot	14
Magyarországra	magyarországra	14
Mészáros Lázár	mészáros lázár	14
Nándorfehérvár	nándorfehérvár	14
Országh Mihály	országh mihály	14
Pálóczy György	pálóczy györgy	14
Schultz Ferenc	schultz ferenc	14
Selmecbányához	selmecbányához	14
Sobieski János	sobieski jános	14
Soklyósy Péter	soklyósy péter	14
Stella Kristóf	stella kristóf	14
Szentlászlóvár	szentlászlóvár	14
Szolnokon Dobó	szolnokon dobó	14
Székesfehérvár	székesfehérvár	14
Tegenyei Tamás	tegenyei tamás	14
Thaly Zsigmond	thaly zsigmond	14
Zrínyiújvárnak	zrínyiújvárnak	14
Érdekességként	érdekességként	14
Alsó-Ausztriát	alsó-ausztriát	14
Balassi Bálint	balassi bálint	14
Batthyány Ádám	batthyány ádám	14
Brandenburgtól	brandenburgtól	14
Breitenfeldnél	breitenfeldnél	14
Báthory István	báthory istván	14
Csillag Kamara	csillag kamara	14
Csillagkamarát	csillagkamarát	14
Dardanelláknál	dardanelláknál	14
Downing Street	downing street	14
Emlékiratokban	emlékiratokban	14
Giorgio Bastát	giorgio bastát	14
Howard Katalin	howard katalin	14
Jakabot Anglia	jakabot anglia	14
Jognyilatkozat	jognyilatkozat	14
Kara Musztafát	kara musztafát	14
Katolikus Liga	katolikus liga	14
Kelet-Európára	kelet-európára	14
Kelet-Indiában	kelet-indiában	14
Krisztiernával	krisztiernával	14
Károlyi Sándor	károlyi sándor	14
Közép-Európába	közép-európába	14
Közép-Kelettel	közép-kelettel	14
Magyarországon	magyarországon	14
Magyarországot	magyarországot	14
Magyarországra	magyarországra	14
Medici Bankház	medici bankház	14
Medici Katalin	medici katalin	14
Medina Sidonia	medina sidonia	14
Mekcsey István	mekcsey istván	14
Miguel Serveto	miguel serveto	14
Morvaországban	morvaországban	14
Nagy-Britannia	nagy-britannia	14
Nassaui Vilmos	nassaui vilmos	14
Nándorfehérvár	nándorfehérvár	14
Németalföldről	németalföldről	14
Pontifikátusát	pontifikátusát	14
Robert Walpole	robert walpole	14
Rodrigo Borgia	rodrigo borgia	14
Schwendi Lázár	schwendi lázár	14
Sennyei István	sennyei istván	14
Skandináviában	skandináviában	14
Sobieski János	sobieski jános	14
Stájerországot	stájerországot	14
Szabadság Fiai	szabadság fiai	14
Szalánkeménnél	szalánkeménnél	14
Szent Bertalan	szent bertalan	14
Szentpétervárt	szentpétervárt	14
Szokoli Mehmed	szokoli mehmed	14
Szokolu Mehmed	szokolu mehmed	14
Számvevőszéket	számvevőszéket	14
Szárd-Piemonti	szárd-piemonti	14
Tanulmányaiban	tanulmányaiban	14
Tiltott Várost	tiltott várost	14
Topkapi Szeráj	topkapi szeráj	14
Walter Raleigh	walter raleigh	14
Észak-Indiában	észak-indiában	14
Összefoglalván	összefoglalván	14
Alexander Bach	alexander bach	14
Alexandru Cuza	alexandru cuza	14
Alfred Dreyfus	alfred dreyfus	14
Alvaro Obregón	alvaro obregón	14
Andrew Jackson	andrew jackson	14
Andrew Johnson	andrew johnson	14
Andrássy Gyula	andrássy gyula	14
Angol Királynő	angol királynő	14
Apponyi Albert	apponyi albert	14
Apponyi György	apponyi györgy	14
Becsületrendet	becsületrendet	14
Campoformióban	campoformióban	14
Charles Darwin	charles darwin	14
Csengery Antal	csengery antal	14
Demokrata Párt	demokrata párt	14
Dessewffy Emil	dessewffy emil	14
Dosztojevszkij	dosztojevszkij	14
Francia-Kongót	francia-kongót	14
Garami Ernővel	garami ernővel	14
Georges Danton	georges danton	14
Határőrvidéket	határőrvidéket	14
Heinrich Heine	heinrich heine	14
Hercegovinában	hercegovinában	14
Hohenzollernek	hohenzollernek	14
Horvát Jogpárt	horvát jogpárt	14
Ignacio Madero	ignacio madero	14
Iljics Uljanov	iljics uljanov	14
Internacionálé	internacionálé	14
Jakobinus Klub	jakobinus klub	14
Kapodisztriast	kapodisztriast	14
Karl Geringert	karl geringert	14
Kelet-Floridát	kelet-floridát	14
Károlyi György	károlyi györgy	14
Kölcsey Ferenc	kölcsey ferenc	14
Közép-Itáliába	közép-itáliába	14
Közép-Ázsiában	közép-ázsiában	14
Lamberg Ferenc	lamberg ferenc	14
Latin-Amerikát	latin-amerikát	14
Liberális Párt	liberális párt	14
Lola Montezhez	lola montezhez	14
Lovassy László	lovassy lászló	14
Ludwig Cobenzl	ludwig cobenzl	14
Lunkányi János	lunkányi jános	14
Magyarországon	magyarországon	14
Magyarországot	magyarországot	14
Magyarországra	magyarországra	14
Mária Lujzának	mária lujzának	14
Mária Lujzával	mária lujzával	14
Nagy-Britannia	nagy-britannia	14
Németországnak	németországnak	14
Németországról	németországról	14
Pesti Naplóban	pesti naplóban	14
Petőfi Nemzeti	petőfi nemzeti	14
Poroszországot	poroszországot	14
Poroszországra	poroszországra	14
Pulszky Ferenc	pulszky ferenc	14
Párizsi Kommün	párizsi kommün	14
Radikális Párt	radikális párt	14
Rosa Luxemburg	rosa luxemburg	14
Saint Domingue	saint domingue	14
Siemens-Martin	siemens-martin	14
Somsich Miklós	somsich miklós	14
Thomas Malthus	thomas malthus	14
Viktor Emánuel	viktor emánuel	14
Villafrancában	villafrancában	14
Vöröskeresztet	vöröskeresztet	14
Wenckheim Béla	wenckheim béla	14
Woodrow Wilson	woodrow wilson	14
Balling János	balling jános	13
Beregszásztól	beregszásztól	13
Camillo Benso	camillo benso	13
Csehországban	csehországban	13
Drégelypalánk	drégelypalánk	13
Egyházas-Nána	egyházas-nána	13
Egyértelműnek	egyértelműnek	13
Evlia Cselebi	evlia cselebi	13
Frantz Mihály	frantz mihály	13
Fráter György	fráter györgy	13
Giulio Turcho	giulio turcho	13
Gyulafehérvár	gyulafehérvár	13
Gyulai Ferenc	gyulai ferenc	13
Habsburgokkal	habsburgokkal	13
Hunyadi János	hunyadi jános	13
Ignaz Lederer	ignaz lederer	13
Ipolyi Arnold	ipolyi arnold	13
Kara Musztafa	kara musztafa	13
Kemény Farkas	kemény farkas	13
Kompoltiaknak	kompoltiaknak	13
Krusith János	krusith jános	13
Kátay Benedek	kátay benedek	13
Köprülü Ahmed	köprülü ahmed	13
Kövesdi Gábor	kövesdi gábor	13
Magyar Kamara	magyar kamara	13
Megyei Tanács	megyei tanács	13
Mikus Hollókő	mikus hollókő	13
Möller István	möller istván	13
Nagyszombaton	nagyszombaton	13
Orsolyaszüzek	orsolyaszüzek	13
Petőfi Sándor	petőfi sándor	13
Poroszországi	poroszországi	13
Pálffy Miklós	pálffy miklós	13
Radics András	radics andrás	13
Rangoni Gábor	rangoni gábor	13
Rhédey Ferenc	rhédey ferenc	13
Sipeky Ferenc	sipeky ferenc	13
Siraki Albert	siraki albert	13
Sulyok Balázs	sulyok balázs	13
Szentháromság	szentháromság	13
Szondi György	szondi györgy	13
Széchy Máriát	széchy máriát	13
Szöllősi Peti	szöllősi peti	13
Teleki László	teleki lászló	13
Tápióbicskére	tápióbicskére	13
Töröktábornak	töröktábornak	13
Ujlaky Lőrinc	ujlaky lőrinc	13
Varkoch Tamás	varkoch tamás	13
Vécsey Sándor	vécsey sándor	13
Wathay Lőrinc	wathay lőrinc	13
Wilhelm Mertz	wilhelm mertz	13
Amszterdamban	amszterdamban	13
Ancien Régime	ancien régime	13
Azerbajdzsánt	azerbajdzsánt	13
Barbarossának	barbarossának	13
Bottyán János	bottyán jános	13
Brandenburgot	brandenburgot	13
Bölcs Frigyes	bölcs frigyes	13
Cesare Borgia	cesare borgia	13
Csáktornyánál	csáktornyánál	13
Császár Péter	császár péter	13
Czartoryskiak	czartoryskiak	13
Denis Diderot	denis diderot	13
Dobzse László	dobzse lászló	13
Egyházi Állam	egyházi állam	13
Enciklopédiát	enciklopédiát	13
Fehrbellinnél	fehrbellinnél	13
Fekete-Afrika	fekete-afrika	13
Franche-Comte	franche-comte	13
Franciaország	franciaország	13
Francis Drake	francis drake	13
Fráter György	fráter györgy	13
Ghyczy András	ghyczy andrás	13
Gusztáv Adolf	gusztáv adolf	13
Habeas Corpus	habeas corpus	13
Habsburgokhoz	habsburgokhoz	13
Habsburgokkal	habsburgokkal	13
Habsburgoknak	habsburgoknak	13
Hivatalnokait	hivatalnokait	13
Igazgatóságot	igazgatóságot	13
Immanuel Kant	immanuel kant	13
Jules Mazarin	jules mazarin	13
János Váradon	jános váradon	13
Kara Musztafa	kara musztafa	13
Karl Mansfeld	karl mansfeld	13
Kelet-Ázsiába	kelet-ázsiába	13
Kunersdorfnál	kunersdorfnál	13
Königsbergben	königsbergben	13
Közel-Keleten	közel-keleten	13
Közép-Chiléig	közép-chiléig	13
Leideni Jakab	leideni jakab	13
Lengyelország	lengyelország	13
Lippay György	lippay györgy	13
Lord Burghley	lord burghley	13
Lotaringiában	lotaringiában	13
Loyolai Ignác	loyolai ignác	13
Magyarországa	magyarországa	13
Majlád István	majlád istván	13
Massachusetts	massachusetts	13
Medici Máriát	medici máriát	13
Mississippiig	mississippiig	13
Morvaországig	morvaországig	13
Morvaországot	morvaországot	13
Nikolsburgban	nikolsburgban	13
Nyugat-Európa	nyugat-európa	13
Nyugat-Indiát	nyugat-indiát	13
Németalföldét	németalföldét	13
Németalföldön	németalföldön	13
Németi Balázs	németi balázs	13
Ocskay László	ocskay lászló	13
Országgyűlést	országgyűlést	13
Perényi Péter	perényi péter	13
Portugáliában	portugáliában	13
Portugáliának	portugáliának	13
Pármai Margit	pármai margit	13
Pázmány Péter	pázmány péter	13
Péterváradnál	péterváradnál	13
Rendi Gyűlést	rendi gyűlést	13
Societas Jesu	societas jesu	13
Spanyolország	spanyolország	13
Stefan Razvan	stefan razvan	13
Szent Hivatal	szent hivatal	13
Szent Jeromos	szent jeromos	13
Szent Ligához	szent ligához	13
Szentháromság	szentháromság	13
Szondi György	szondi györgy	13
Székely Mózes	székely mózes	13
Székelyföldet	székelyföldet	13
Székelytámadt	székelytámadt	13
Temesi Bánság	temesi bánság	13
Tenochtitlant	tenochtitlant	13
Theresianumot	theresianumot	13
Thomas Münzer	thomas münzer	13
Thomas Wolsey	thomas wolsey	13
Thököly-Apafi	thököly-apafi	13
Titkos Tanács	titkos tanács	13
Ulrich Hutten	ulrich hutten	13
Valladolidban	valladolidban	13
William Cecil	william cecil	13
William Paget	william paget	13
Észak-Amerika	észak-amerika	13
Alkotmánypárt	alkotmánypárt	13
Antikrisztust	antikrisztust	13
Arakcsejevnek	arakcsejevnek	13
Beecher-Stowe	beecher-stowe	13
Benito Juárez	benito juárez	13
Cecil Rhodest	cecil rhodest	13
Choveve Ciont	choveve ciont	13
David Ricardo	david ricardo	13
Déli Társaság	déli társaság	13
Edward Jenner	edward jenner	13
Epidauroszban	epidauroszban	13
Forgách Antal	forgách antal	13
Forinyák Géza	forinyák géza	13
Franciaország	franciaország	13
Guyon Richárd	guyon richárd	13
Görgey Artúrt	görgey artúrt	13
Harpers Ferry	harpers ferry	13
Iparegyesület	iparegyesület	13
Irinyi József	irinyi józsef	13
Kasszandrához	kasszandrához	13
Kelet-Európát	kelet-európát	13
Kialakították	kialakították	13
Klauzál Gábor	klauzál gábor	13
Korona Budára	korona budára	13
Kossuth Lajos	kossuth lajos	13
Közép-Európát	közép-európát	13
Közép-Itáliát	közép-itáliát	13
Latin-Amerika	latin-amerika	13
Lengyelország	lengyelország	13
Libényi János	libényi jános	13
Lord Cardigan	lord cardigan	13
Lukács László	lukács lászló	13
Madagaszkáron	madagaszkáron	13
Magyar Korona	magyar korona	13
Mailáth Antal	mailáth antal	13
Matthew Perry	matthew perry	13
Nagy-Bulgária	nagy-bulgária	13
Nagy-Kolumbia	nagy-kolumbia	13
Neervindennél	neervindennél	13
Nyugat-Európa	nyugat-európa	13
Németországon	németországon	13
Németországot	németországot	13
Németországra	németországra	13
Pomutz György	pomutz györgy	13
Porfirio Díaz	porfirio díaz	13
Portugáliában	portugáliában	13
Saint-Antoine	saint-antoine	13
Schwarzenberg	schwarzenberg	13
Simón Bolívar	simón bolívar	13
Spanyolország	spanyolország	13
Szalay László	szalay lászló	13
Szlávy József	szlávy józsef	13
Szécsen Antal	szécsen antal	13
Székelyföldön	székelyföldön	13
Thierskormány	thierskormány	13
Tiszaeszláron	tiszaeszláron	13
Távol-Keletre	távol-keletre	13
Türkmenisztán	türkmenisztán	13
Vetsera Mária	vetsera mária	13
Viharsarokban	viharsarokban	13
Vukovics Sebő	vukovics sebő	13
Várnégyszögbe	várnégyszögbe	13
Városligetben	városligetben	13
Vének Tanácsa	vének tanácsa	13
Washingtonnak	washingtonnak	13
Észak-Algéria	észak-algéria	13
Észak-Amerika	észak-amerika	13
Északitengert	északitengert	13
IMPERIALIZMUS	imperializmus	13
Apafi Mihály	apafi mihály	12
Bakich Péter	bakich péter	12
Balassa Imre	balassa imre	12
Balogh János	balogh jános	12
Berki Mátyás	berki mátyás	12
Bodor István	bodor istván	12
Bodor Mihály	bodor mihály	12
Bornemisszát	bornemisszát	12
Bécsbe Mertz	bécsbe mertz	12
Búcsúlevelét	búcsúlevelét	12
Corvin János	corvin jános	12
Csáky András	csáky andrás	12
Drinápolyban	drinápolyban	12
Drinápolyból	drinápolyból	12
Dávid Ferenc	dávid ferenc	12
Dózsa György	dózsa györgy	12
Egressy Béni	egressy béni	12
Fogarasföldi	fogarasföldi	12
Forgách Ádám	forgách ádám	12
Garai Miklós	garai miklós	12
Habsburgokat	habsburgokat	12
Habsburgokra	habsburgokra	12
Homokhegytől	homokhegytől	12
Horváth Anna	horváth anna	12
Horváth Márk	horváth márk	12
Hunyadi Vajk	hunyadi vajk	12
Hódoltságnak	hódoltságnak	12
Jancsikaként	jancsikaként	12
Joseph Turin	joseph turin	12
Kapitalizmus	kapitalizmus	12
Katalin Anna	katalin anna	12
Katinkáékhoz	katinkáékhoz	12
Kendy Ferenc	kendy ferenc	12
Keresztesnél	keresztesnél	12
Kompoltiakat	kompoltiakat	12
Komáromfalva	komáromfalva	12
Lenkey János	lenkey jános	12
Lombardiáról	lombardiáról	12
Lovász-Nánát	lovász-nánát	12
Lénárt János	lénárt jános	12
Magyarország	magyarország	12
Mindemellett	mindemellett	12
Mindenesetre	mindenesetre	12
Normandiában	normandiában	12
Orczy István	orczy istván	12
Országcsalád	országcsalád	12
Perényiekkel	perényiekkel	12
Perényieknek	perényieknek	12
Révay Ferenc	révay ferenc	12
Rómer Flóris	rómer flóris	12
Saáry László	saáry lászló	12
Siklósiaktól	siklósiaktól	12
Széchy Dénes	széchy dénes	12
Széchy Mária	széchy mária	12
Sárospatakon	sárospatakon	12
Thaly Kálmán	thaly kálmán	12
Történelmünk	történelmünk	12
Törökkanizsa	törökkanizsa	12
Ujváry János	ujváry jános	12
Világörökség	világörökség	12
Vitéz Mihály	vitéz mihály	12
Észak-Erdély	észak-erdély	12
Andrea Doria	andrea doria	12
Apátfalvánál	apátfalvánál	12
Badeni Lajos	badeni lajos	12
Balassa Imre	balassa imre	12
Bekes Gáspár	bekes gáspár	12
Boleyn Annát	boleyn annát	12
Bourbonokkal	bourbonokkal	12
Bánffy Dénes	bánffy dénes	12
Chateubriand	chateubriand	12
Corvin János	corvin jános	12
Csaldiránnál	csaldiránnál	12
Csáky Miklós	csáky miklós	12
Dettingennél	dettingennél	12
Drinápolyban	drinápolyban	12
Drinápolyból	drinápolyból	12
Dávid Ferenc	dávid ferenc	12
Elképzelései	elképzelései	12
Enciklopédia	enciklopédia	12
Erős Ágostot	erős ágostot	12
Fehérhegynél	fehérhegynél	12
Fejedelemség	fejedelemség	12
Ghyczy János	ghyczy jános	12
Grand Armada	grand armada	12
Gyurgyevónál	gyurgyevónál	12
Habsburgokat	habsburgokat	12
Habsburgokra	habsburgokra	12
Haireddinnel	haireddinnel	12
Hercegovinát	hercegovinát	12
Hohenzollern	hohenzollern	12
Hollandiában	hollandiában	12
Hollandiának	hollandiának	12
Horvátország	horvátország	12
Hétszemélyes	hétszemélyes	12
Höchstadtnál	höchstadtnál	12
Jane Seymour	jane seymour	12
Jenyiszejszk	jenyiszejszk	12
Kelet-Európa	kelet-európa	12
Kollégiumnak	kollégiumnak	12
Kolumbusszal	kolumbusszal	12
Kozma Minyin	kozma minyin	12
Közép-Európa	közép-európa	12
Közép-Ázsián	közép-ázsián	12
Lombardiáról	lombardiáról	12
Lotharingiát	lotharingiát	12
Magyarország	magyarország	12
Medici Mária	medici mária	12
Mezopotámiát	mezopotámiát	12
Michelangelo	michelangelo	12
Montecuccoli	montecuccoli	12
Nagypáholyát	nagypáholyát	12
Nyugat-India	nyugat-india	12
Nyáry Lőrinc	nyáry lőrinc	12
Pannonhalmát	pannonhalmát	12
Parr Katalin	parr katalin	12
Philippsburg	philippsburg	12
Poroszország	poroszország	12
Robert Clive	robert clive	12
Ráday Pálnak	ráday pálnak	12
Samuel Adams	samuel adams	12
Savoyai Jenő	savoyai jenő	12
Szent György	szent györgy	12
Szent Juntát	szent juntát	12
Szent Korona	szent korona	12
Szent Ligába	szent ligába	12
Szent Ligája	szent ligája	12
Szent Lőrinc	szent lőrinc	12
Szent Mihály	szent mihály	12
Szentföldről	szentföldről	12
Szir-Darjáig	szir-darjáig	12
Székelybánja	székelybánja	12
Sánta Márton	sánta márton	12
Sárospatakon	sárospatakon	12
Sárospatakra	sárospatakra	12
Thomas Morus	thomas morus	12
William Laud	william laud	12
William Pitt	william pitt	12
Észak-Európa	észak-európa	12
Észak-Itália	észak-itália	12
Ószövetséget	ószövetséget	12
Örményország	örményország	12
Appomatoxnál	appomatoxnál	12
August Bebel	august bebel	12
Augusz Antal	augusz antal	12
Ausztráliába	ausztráliába	12
Baross Gábor	baross gábor	12
Battenberget	battenberget	12
Besszarábiát	besszarábiát	12
Bonapartéval	bonapartéval	12
Borogyinónál	borogyinónál	12
Buenos Aires	buenos aires	12
Centrum Párt	centrum párt	12
Cesare Balbo	cesare balbo	12
Ciszlajtánia	ciszlajtánia	12
Claude-Henri	claude-henri	12
Dózsa György	dózsa györgy	12
Edmund Burke	edmund burke	12
Finnországot	finnországot	12
Fényes Porta	fényes porta	12
Gibraltárban	gibraltárban	12
Guayaquilben	guayaquilben	12
Haza Oltárát	haza oltárát	12
Henri Dunant	henri dunant	12
Hercegovinát	hercegovinát	12
Hollandiából	hollandiából	12
Horvátország	horvátország	12
István Hitel	istván hitel	12
James Monroe	james monroe	12
Karadjordjét	karadjordjét	12
Kmety György	kmety györgy	12
Konföderáció	konföderáció	12
Ledru-Rollin	ledru-rollin	12
Lloyd George	lloyd george	12
Lombardiából	lombardiából	12
Ludwig Börne	ludwig börne	12
Macedóniában	macedóniában	12
Magyarország	magyarország	12
Marseillaise	marseillaise	12
Mexikóvárost	mexikóvárost	12
Mindemellett	mindemellett	12
Minisztérium	minisztérium	12
Monarchiában	monarchiában	12
Monarchiához	monarchiához	12
Monarchiával	monarchiával	12
Nagy Frigyes	nagy frigyes	12
Nagy Katalin	nagy katalin	12
Nagy Tavakig	nagy tavakig	12
Nagysallónál	nagysallónál	12
Olvasóegylet	olvasóegylet	12
Palesztínára	palesztínára	12
Pesti Hírlap	pesti hírlap	12
Poroszország	poroszország	12
Romanovokban	romanovokban	12
Ráday Gedeon	ráday gedeon	12
Rózsa Sándor	rózsa sándor	12
Saint-Cloude	saint-cloude	12
Schwechatnál	schwechatnál	12
Schönerernek	schönerernek	12
Sigray Jakab	sigray jakab	12
Szentszékkel	szentszékkel	12
Szevasztopol	szevasztopol	12
Szperanszkij	szperanszkij	12
Szövetséggel	szövetséggel	12
Szövetséghez	szövetséghez	12
Szövetségnek	szövetségnek	12
Sárospatakon	sárospatakon	12
Thököly Imre	thököly imre	12
Transvaalban	transvaalban	12
Tuilleriákat	tuilleriákat	12
Urak Házában	urak házában	12
Vetter Antal	vetter antal	12
Villamossági	villamossági	12
Világszellem	világszellem	12
Vorarlberget	vorarlberget	12
Vámszövetség	vámszövetség	12
Washingtonba	washingtonba	12
William Pitt	william pitt	12
Wounded Knee	wounded knee	12
Zichy Ferenc	zichy ferenc	12
Zichy Nándor	zichy nándor	12
Áchim András	áchim andrás	12
Acélmágnást	acélmágnást	11
Alpár Ignác	alpár ignác	11
Amtman Jenő	amtman jenő	11
Arany János	arany jános	11
Avram Iancu	avram iancu	11
Besze János	besze jános	11
Bithyniának	bithyniának	11
Bornemissza	bornemissza	11
Brigetióban	brigetióban	11
Carlo Theti	carlo theti	11
Cserépvárat	cserépvárat	11
Csillagerőd	csillagerőd	11
Csáktornyán	csáktornyán	11
Czibak Imre	czibak imre	11
Debrecenben	debrecenben	11
Dobóruszkán	dobóruszkán	11
Exellenciád	exellenciád	11
Fejér Tamás	fejér tamás	11
Földbástyák	földbástyák	11
Földbástyát	földbástyát	11
Galambóccal	galambóccal	11
Geréb Péter	geréb péter	11
Gerő László	gerő lászló	11
Gibraltárja	gibraltárja	11
Havasalföld	havasalföld	11
Helfy Ignác	helfy ignác	11
Homokhegyen	homokhegyen	11
Homokhegyet	homokhegyet	11
Hontpázmány	hontpázmány	11
Izabellának	izabellának	11
Jedikulában	jedikulában	11
Juliannával	juliannával	11
Kecskeméten	kecskeméten	11
Kerékgyártó	kerékgyártó	11
Kolozsváron	kolozsváron	11
Kosztolányi	kosztolányi	11
Krisztustól	krisztustól	11
Kárpátalján	kárpátalján	11
Kárpátalját	kárpátalját	11
Következzék	következzék	11
Lagylucskán	lagylucskán	11
Losonczytól	losonczytól	11
Lovász-Nána	lovász-nána	11
Nagy Ferenc	nagy ferenc	11
Nagyecseden	nagyecseden	11
Nikodémiába	nikodémiába	11
Oderbergből	oderbergből	11
Olaszország	olaszország	11
Orban Suess	orban suess	11
Oroszlánban	oroszlánban	11
Oroszország	oroszország	11
Ozorai Pipo	ozorai pipo	11
Sbardellati	sbardellati	11
Selmecbánya	selmecbánya	11
Simor János	simor jános	11
Sulyok Sára	sulyok sára	11
Szamosújvár	szamosújvár	11
Szentmárton	szentmárton	11
Szerednyére	szerednyére	11
Tary Rupert	tary rupert	11
Thurzófalva	thurzófalva	11
Tiszántúlon	tiszántúlon	11
Törökország	törökország	11
Urban Süess	urban süess	11
Vajdahunyad	vajdahunyad	11
Waterloonál	waterloonál	11
Öregtornyot	öregtornyot	11
Örsi Ferenc	örsi ferenc	11
Abdurrahman	abdurrahman	11
Alsó-Elzász	alsó-elzász	11
Angol Kelet	angol kelet	11
Angyalvárat	angyalvárat	11
Angyalvárba	angyalvárba	11
Anjou Fülöp	anjou fülöp	11
Aranybullát	aranybullát	11
Augsburgban	augsburgban	11
Ausztriában	ausztriában	11
Ausztriának	ausztriának	11
Ausztriával	ausztriával	11
Bajorország	bajorország	11
Batthyányak	batthyányak	11
Boleyn Anna	boleyn anna	11
Bolotnyikov	bolotnyikov	11
Borgiákétól	borgiákétól	11
Brandenburg	brandenburg	11
Brüsszelben	brüsszelben	11
Bányavidéki	bányavidéki	11
Castaldónak	castaldónak	11
Christianae	christianae	11
Connecticut	connecticut	11
Czibak Imre	czibak imre	11
Dobó István	dobó istván	11
Dunántúlnak	dunántúlnak	11
Egyiptomban	egyiptomban	11
Egyiptommal	egyiptommal	11
Eidgenossen	eidgenossen	11
Eufráteszig	eufráteszig	11
Európájának	európájának	11
Falkenstein	falkenstein	11
Farkashidán	farkashidán	11
Felső-Tisza	felső-tisza	11
Felvidékről	felvidékről	11
Ferdinándra	ferdinándra	11
Flandriában	flandriában	11
Flandriával	flandriával	11
Frankföldre	frankföldre	11
Fuggerektől	fuggerektől	11
Fázil Ahmed	fázil ahmed	11
George Monk	george monk	11
György Bécs	györgy bécs	11
Haireddinre	haireddinre	11
Havasalföld	havasalföld	11
Hispaniolát	hispaniolát	11
Hármaskönyv	hármaskönyv	11
Igazságügyi	igazságügyi	11
Inigo López	inigo lópez	11
Jagellókkal	jagellókkal	11
Jagellóktól	jagellóktól	11
Jóreménység	jóreménység	11
Kambodzsába	kambodzsába	11
Kancellária	kancellária	11
Királyhágón	királyhágón	11
Kismartonba	kismartonba	11
Kizil Elmát	kizil elmát	11
Kollár Ádám	kollár ádám	11
Kolozsvárra	kolozsvárra	11
Kongresszus	kongresszus	11
Krisztierna	krisztierna	11
Közép-Ázsia	közép-ázsia	11
Lala Mehmed	lala mehmed	11
Leszczynski	leszczynski	11
Litvániával	litvániával	11
Lotharingia	lotharingia	11
Magdeburgot	magdeburgot	11
Magántanács	magántanács	11
Marlborough	marlborough	11
Miriszlónál	miriszlónál	11
Montesquieu	montesquieu	11
Nagyszombat	nagyszombat	11
Nagyváradot	nagyváradot	11
Németalföld	németalföld	11
Németország	németország	11
Oláh Miklós	oláh miklós	11
Oroszország	oroszország	11
Orániaiakat	orániaiakat	11
Paine Józan	paine józan	11
Pazmaneumot	pazmaneumot	11
Pedro Lasso	pedro lasso	11
Pillnitzben	pillnitzben	11
Piri Mehmed	piri mehmed	11
Poniatowski	poniatowski	11
Portugáliát	portugáliát	11
Pozsareváci	pozsareváci	11
Pozsarszkij	pozsarszkij	11
Pápai Állam	pápai állam	11
Radu Serban	radu serban	11
Saint Denis	saint denis	11
Salvadornak	salvadornak	11
Salzburgból	salzburgból	11
Santa María	santa maría	11
Saratogánál	saratogánál	11
Schleswiget	schleswiget	11
Shakespeare	shakespeare	11
Skandinávia	skandinávia	11
Sobieskinek	sobieskinek	11
Starhemberg	starhemberg	11
Szent János	szent jános	11
Szent Ligát	szent ligát	11
Szent Péter	szent péter	11
Szentendrét	szentendrét	11
Szepességet	szepességet	11
Szepességig	szepességig	11
Szicíliához	szicíliához	11
Szugyebnyik	szugyebnyik	11
Szászföldre	szászföldre	11
Szászország	szászország	11
Thüringiába	thüringiába	11
Tiszántúlon	tiszántúlon	11
Tiszántúlra	tiszántúlra	11
Torstensonn	torstensonn	11
Tripartitum	tripartitum	11
Tádzs Mahal	tádzs mahal	11
Távol-Kelet	távol-kelet	11
Tóth Mihály	tóth mihály	11
Törökország	törökország	11
Valenciában	valenciában	11
Világosvárt	világosvárt	11
Wallenstein	wallenstein	11
Wittelsbach	wittelsbach	11
Államtanács	államtanács	11
Észak-India	észak-india	11
Észak-Ázsia	észak-ázsia	11
Afganisztán	afganisztán	11
Anatóliából	anatóliából	11
Andrássyhoz	andrássyhoz	11
Ausztriában	ausztriában	11
Ausztriából	ausztriából	11
Ausztriának	ausztriának	11
Ausztriáról	ausztriáról	11
Ausztriával	ausztriával	11
Bajorország	bajorország	11
Balítéletek	balítéletek	11
Beauharnais	beauharnais	11
Besszarábia	besszarábia	11
Beöthy Ödön	beöthy ödön	11
Biarritzban	biarritzban	11
Bibó István	bibó istván	11
Bourbonokat	bourbonokat	11
Branyiszkói	branyiszkói	11
Brit-Indiát	brit-indiát	11
Bukarestben	bukarestben	11
Bulgáriában	bulgáriában	11
Bulgáriával	bulgáriával	11
Békéscsabán	békéscsabán	11
Camphausent	camphausent	11
Carranzának	carranzának	11
Chamberlain	chamberlain	11
Changarnier	changarnier	11
Csáky Albin	csáky albin	11
Custozzánál	custozzánál	11
Dardanellák	dardanellák	11
Direktórium	direktórium	11
Dutch Shell	dutch shell	11
Európájának	európájának	11
Goluchowski	goluchowski	11
Görögország	görögország	11
Havasalföld	havasalföld	11
Hegypártnak	hegypártnak	11
Hercegovina	hercegovina	11
Hátsó-India	hátsó-india	11
Igazgatóság	igazgatóság	11
Indokínában	indokínában	11
Inkermannál	inkermannál	11
Innsbruckba	innsbruckba	11
Invalidusok	invalidusok	11
Jules Ferry	jules ferry	11
Jules Grévy	jules grévy	11
Justh Gyula	justh gyula	11
Karadjordje	karadjordje	11
Karlsbadban	karlsbadban	11
Kelet-Közép	kelet-közép	11
Kronstadtba	kronstadtba	11
Kulturkampf	kulturkampf	11
Közel-Kelet	közel-kelet	11
Köztársaság	köztársaság	11
Közép-Ázsia	közép-ázsia	11
Lord Raglan	lord raglan	11
Lordok Háza	lordok háza	11
Magyar Ipar	magyar ipar	11
Martinovics	martinovics	11
Mazziniéval	mazziniéval	11
Mississippi	mississippi	11
Morvaország	morvaország	11
Mária Lujza	mária lujza	11
Nagy Sándor	nagy sándor	11
Nyilatkozat	nyilatkozat	11
Németalföld	németalföld	11
Németország	németország	11
Obrenovicra	obrenovicra	11
Olaszország	olaszország	11
Oroszország	oroszország	11
Palesztinát	palesztinát	11
Pazvan Oglu	pazvan oglu	11
Podmaniczky	podmaniczky	11
Port Arthur	port arthur	11
Portugáliát	portugáliát	11
Pápai Állam	pápai állam	11
Rajna-Pfalz	rajna-pfalz	11
Reform Bill	reform bill	11
Richmondnak	richmondnak	11
Robespierre	robespierre	11
Saarbrücken	saarbrücken	11
Saint-Simon	saint-simon	11
Stuart Mill	stuart mill	11
Szabó Ervin	szabó ervin	11
Szenegálban	szenegálban	11
Szepességet	szepességet	11
Szicíliában	szicíliában	11
Sziléziában	sziléziában	11
Szászország	szászország	11
Szövetséget	szövetséget	11
Tocqueville	tocqueville	11
Tudósítások	tudósítások	11
Törökország	törökország	11
Türr István	türr istván	11
Ugron Gábor	ugron gábor	11
Vesztfáliát	vesztfáliát	11
Visztulától	visztulától	11
Wartburgban	wartburgban	11
Washingtont	washingtont	11
Wenckheimek	wenckheimek	11
Württemberg	württemberg	11
Államtanács	államtanács	11
Észak-India	észak-india	11
Ügyosztályt	ügyosztályt	11
Alsó-Maros	alsó-maros	10
Bebek Imre	bebek imre	10
Benyovszky	benyovszky	10
Borh-Bodon	borh-bodon	10
Boszniában	boszniában	10
Celemantia	celemantia	10
Csáktornya	csáktornya	10
Császárság	császárság	10
Dembinszki	dembinszki	10
Dembinszky	dembinszky	10
Demoiseaux	demoiseaux	10
Drégellyel	drégellyel	10
Drégelynek	drégelynek	10
Drégelyvár	drégelyvár	10
Dunántúlon	dunántúlon	10
Dunántúlra	dunántúlra	10
Eszterházy	eszterházy	10
Fizikailag	fizikailag	10
Fordulatot	fordulatot	10
Forró Elek	forró elek	10
Földbástya	földbástya	10
Haditanács	haditanács	10
Herbeville	herbeville	10
Husz János	husz jános	10
Házasságuk	házasságuk	10
Kapisztrán	kapisztrán	10
Katinkának	katinkának	10
Komáromnak	komáromnak	10
Konstantin	konstantin	10
Különleges	különleges	10
Legerősebb	legerősebb	10
Lőkamrákat	lőkamrákat	10
Mátyusföld	mátyusföld	10
Mócföldről	mócföldről	10
Műjégpálya	műjégpálya	10
Nagy Lajos	nagy lajos	10
Nagy Orbán	nagy orbán	10
Nagyigmánd	nagyigmánd	10
Nagylucska	nagylucska	10
Nagyoroszi	nagyoroszi	10
Nagyszőlős	nagyszőlős	10
Nagyságtok	nagyságtok	10
Neustadter	neustadter	10
Nyalábvára	nyalábvára	10
Nyárasdnál	nyárasdnál	10
Nádorvonal	nádorvonal	10
Németújvár	németújvár	10
Paradeiser	paradeiser	10
Pozsarevác	pozsarevác	10
Pétervárad	pétervárad	10
Sirokallya	sirokallya	10
Steinville	steinville	10
Szeptember	szeptember	10
Szolnokról	szolnokról	10
Székelyhíd	székelyhíd	10
Ugyanennek	ugyanennek	10
Velencével	velencével	10
Világosnál	világosnál	10
Várainkkal	várainkkal	10
Érchegység	érchegység	10
Érsekújvár	érsekújvár	10
Öregtorony	öregtorony	10
Újpalánkán	újpalánkán	10
Amerikából	amerikából	10
Angol Bank	angol bank	10
Antillákon	antillákon	10
Aranybulla	aranybulla	10
Aranyhorda	aranyhorda	10
Argentínát	argentínát	10
Austriának	austriának	10
Ausztrália	ausztrália	10
Baktérítőn	baktérítőn	10
Baltikumba	baltikumba	10
Barcelonát	barcelonát	10
Belgioioso	belgioioso	10
Birodalmat	birodalmat	10
Brabantban	brabantban	10
Buckingham	buckingham	10
Cagliostro	cagliostro	10
Canterbury	canterbury	10
Coccejivel	coccejivel	10
Cornwallis	cornwallis	10
Csehország	csehország	10
Császárság	császárság	10
Cumberland	cumberland	10
Duna-Tisza	duna-tisza	10
Dunántúlon	dunántúlon	10
Dunántúlra	dunántúlra	10
Délvidékre	délvidékre	10
Egyenlítőt	egyenlítőt	10
Egyiptomon	egyiptomon	10
Egyiptomra	egyiptomra	10
Escorialba	escorialba	10
Esze Tamás	esze tamás	10
Felvidéket	felvidéket	10
Filozófiai	filozófiai	10
Finnország	finnország	10
Gregoriana	gregoriana	10
Haditanács	haditanács	10
Hargreaves	hargreaves	10
Hedzsászra	hedzsászra	10
Herbeville	herbeville	10
Hispaniola	hispaniola	10
Hollandiát	hollandiát	10
Hradzsinba	hradzsinba	10
Ibráhimmal	ibráhimmal	10
Institutio	institutio	10
Izabellára	izabellára	10
James Cook	james cook	10
James Watt	james watt	10
Kahlenberg	kahlenberg	10
Kamcsatkát	kamcsatkát	10
Kara Ahmed	kara ahmed	10
Keresztény	keresztény	10
Khoraszánt	khoraszánt	10
Kincstárat	kincstárat	10
Kosciuszko	kosciuszko	10
Károlyinak	károlyinak	10
Lepantónál	lepantónál	10
Lombardiát	lombardiát	10
Maupertois	maupertois	10
Melanchton	melanchton	10
Messiásnak	messiásnak	10
Nagy Péter	nagy péter	10
Nagyszeben	nagyszeben	10
Pireneusok	pireneusok	10
Poltavához	poltavához	10
Port-Royal	port-royal	10
Portugália	portugália	10
Párkánynál	párkánynál	10
Pázmánnyal	pázmánnyal	10
Péterváron	péterváron	10
Rajna-Duna	rajna-duna	10
Regensburg	regensburg	10
Rodostóban	rodostóban	10
Roggendorf	roggendorf	10
Savonarola	savonarola	10
Servetónak	servetónak	10
Settlement	settlement	10
Sforzákkal	sforzákkal	10
Svábföldön	svábföldön	10
Svédország	svédország	10
Szaharától	szaharától	10
Szardíniát	szardíniát	10
Szefevidák	szefevidák	10
Szent Liga	szent liga	10
Szentlélek	szentlélek	10
Szentírást	szentírást	10
Szerencsre	szerencsre	10
Szibériába	szibériába	10
Sziléziára	sziléziára	10
Sztroganov	sztroganov	10
Szép Fülöp	szép fülöp	10
Szűz Mária	szűz mária	10
Teréziával	teréziával	10
Thökölynek	thökölynek	10
Timur Lenk	timur lenk	10
Tiszaháton	tiszaháton	10
Tiszántúlt	tiszántúlt	10
Toscanában	toscanában	10
Toscanával	toscanával	10
Ukrajnában	ukrajnában	10
Utrechtben	utrechtben	10
Velencének	velencének	10
Velencével	velencével	10
Versailles	versailles	10
Veszprémet	veszprémet	10
Vesztfália	vesztfália	10
Visegrádot	visegrádot	10
Washington	washington	10
Wesselényi	wesselényi	10
Wittenberg	wittenberg	10
Érsekújvár	érsekújvár	10
Aehrenthal	aehrenthal	10
Amennyiben	amennyiben	10
Amszterdam	amszterdam	10
Apponyinak	apponyinak	10
Austerlitz	austerlitz	10
Ausztriára	ausztriára	10
Ausztrália	ausztrália	10
Benningsen	benningsen	10
Bernadotte	bernadotte	10
Birodalmat	birodalmat	10
Birodalmon	birodalmon	10
Bonaparték	bonaparték	10
Bonapartét	bonapartét	10
Boszniának	boszniának	10
Boszporusz	boszporusz	10
Brit-India	brit-india	10
Bukovinába	bukovinába	10
Clemenceau	clemenceau	10
Csuzimánál	csuzimánál	10
Császárság	császárság	10
Debrecenbe	debrecenbe	10
Desmoulins	desmoulins	10
Diplomában	diplomában	10
Délvidéken	délvidéken	10
Döblingben	döblingben	10
Egyetértés	egyetértés	10
Egyiptomra	egyiptomra	10
Fashodából	fashodából	10
Fashodához	fashodához	10
Felix Díaz	felix díaz	10
Felvidéken	felvidéken	10
Galíciáért	galíciáért	10
Georgicont	georgicont	10
Habsburgok	habsburgok	10
Hansemannt	hansemannt	10
Hardenberg	hardenberg	10
Hetilapban	hetilapban	10
Hollandiát	hollandiát	10
Izvolszkij	izvolszkij	10
James Watt	james watt	10
Jövendőnek	jövendőnek	10
Karolingok	karolingok	10
Kellermann	kellermann	10
Kolozsvárt	kolozsvárt	10
Kolumbiába	kolumbiába	10
Kosciuszko	kosciuszko	10
Kremsierbe	kremsierbe	10
Kuomintang	kuomintang	10
Laibachban	laibachban	10
Lembergben	lembergben	10
Lombardiát	lombardiát	10
Louisianát	louisianát	10
Macedóniát	macedóniát	10
Mandzsúria	mandzsúria	10
Marengónál	marengónál	10
Memorandum	memorandum	10
Menyhértet	menyhértet	10
Metternich	metternich	10
Monarchián	monarchián	10
Monarchiát	monarchiát	10
Montenegró	montenegró	10
Montmartre	montmartre	10
Munkáspárt	munkáspárt	10
Móga János	móga jános	10
Nesselrode	nesselrode	10
Norvégiára	norvégiára	10
Notre-Dame	notre-dame	10
Novibazari	novibazari	10
Odesszában	odesszában	10
Palermóban	palermóban	10
Palesztina	palesztina	10
Palmerston	palmerston	10
Parancsoló	parancsoló	10
Paszkevics	paszkevics	10
Pomerániát	pomerániát	10
Portugália	portugália	10
Raszputyin	raszputyin	10
Richmondot	richmondot	10
Saint-Just	saint-just	10
Salzburgot	salzburgot	10
Schlieffen	schlieffen	10
Schmerling	schmerling	10
Scitovszky	scitovszky	10
Settlement	settlement	10
Svédország	svédország	10
Szabadelvű	szabadelvű	10
Szaharától	szaharától	10
Szeptember	szeptember	10
Szerbiából	szerbiából	10
Szerbiának	szerbiának	10
Szerbiával	szerbiával	10
Szibériába	szibériába	10
Talleyrand	talleyrand	10
Tegetthoff	tegetthoff	10
Tepedeleni	tepedeleni	10
Transvaalt	transvaalt	10
Treitschke	treitschke	10
Tribunátus	tribunátus	10
Tripoliszt	tripoliszt	10
Troppauban	troppauban	10
Társadalmi	társadalmi	10
Urbariumot	urbariumot	10
Vatikánnal	vatikánnal	10
Velencéhez	velencéhez	10
Versailles	versailles	10
Világosnál	világosnál	10
Városházán	városházán	10
Vörösmarty	vörösmarty	10
Wellington	wellington	10
Wesselényi	wesselényi	10
Zichy Ödön	zichy ödön	10
Zollverein	zollverein	10
nffy Dezső	nffy dezső	10
REFORMKORI	reformkori	10
Alaptolma	alaptolma	9
Alexandru	alexandru	9
Aranygomb	aranygomb	9
Augusztus	augusztus	9
Baglyaskő	baglyaskő	9
Baldigara	baldigara	9
Batthyány	batthyány	9
Birodalom	birodalom	9
Borgiaról	borgiaról	9
Caprarára	caprarára	9
Csallóköz	csallóköz	9
Damjanich	damjanich	9
Diósgyőrt	diósgyőrt	9
Drégelyre	drégelyre	9
Eger-Buda	eger-buda	9
Elutazása	elutazása	9
Esterházy	esterházy	9
Esztergom	esztergom	9
Fejlődött	fejlődött	9
Ferdinánd	ferdinánd	9
Ficzkónak	ficzkónak	9
Frangepán	frangepán	9
Galgóchoz	galgóchoz	9
Genovában	genovában	9
Genovából	genovából	9
Gizellára	gizellára	9
Gyarmatot	gyarmatot	9
Gyarmatra	gyarmatra	9
Géza Egri	géza egri	9
Hedvignek	hedvignek	9
Hunyadiak	hunyadiak	9
Hunyadvár	hunyadvár	9
Héttorony	héttorony	9
Itáliában	itáliában	9
Jablonkai	jablonkai	9
Jellasics	jellasics	9
Karlovics	karlovics	9
Karlovitz	karlovitz	9
Katinkába	katinkába	9
Komáromba	komáromba	9
Komáromot	komáromot	9
Komáromra	komáromra	9
Krisztina	krisztina	9
Kövesdiné	kövesdiné	9
Lipcsében	lipcsében	9
Londonban	londonban	9
Lorántffy	lorántffy	9
Lőrincnek	lőrincnek	9
Majthényi	majthényi	9
Moldvában	moldvában	9
Monarchia	monarchia	9
Monostori	monostori	9
Máramaros	máramaros	9
Múltjában	múltjában	9
Nagyvárad	nagyvárad	9
Neissében	neissében	9
Nemsokára	nemsokára	9
Normandia	normandia	9
Palócföld	palócföld	9
Pusztavár	pusztavár	9
Querlonde	querlonde	9
Régészeti	régészeti	9
Schönborn	schönborn	9
Sebestyén	sebestyén	9
Siklósról	siklósról	9
Sirokalja	sirokalja	9
Sisatovac	sisatovac	9
Strahurai	strahurai	9
Szabadság	szabadság	9
Szandával	szandával	9
Szapolyai	szapolyai	9
Szarvaskő	szarvaskő	9
Szigetvár	szigetvár	9
Szlovákia	szlovákia	9
Szolnokot	szolnokot	9
Sztrahora	sztrahora	9
Szulejmán	szulejmán	9
Szászföld	szászföld	9
Széchenyi	széchenyi	9
Sébastien	sébastien	9
Törvények	törvények	9
Ugyancsak	ugyancsak	9
Valójában	valójában	9
Vencelnek	vencelnek	9
Várainkat	várainkat	9
Vénuszhoz	vénuszhoz	9
Zsuzsanna	zsuzsanna	9
Ószőnynél	ószőnynél	9
Albániáig	albániáig	9
Alleghany	alleghany	9
Almafához	almafához	9
Amerikába	amerikába	9
Amsterdam	amsterdam	9
Anatóliát	anatóliát	9
Angliából	angliából	9
Angliával	angliával	9
Antwerpen	antwerpen	9
Aurangzeb	aurangzeb	9
Ausztriát	ausztriát	9
Balkánról	balkánról	9
Bercsényi	bercsényi	9
Berlinben	berlinben	9
Bibliából	bibliából	9
Bibliával	bibliával	9
Birodalom	birodalom	9
Brazíliát	brazíliát	9
Brodarics	brodarics	9
Bukovinát	bukovinát	9
Burgundia	burgundia	9
Cambridge	cambridge	9
Condillac	condillac	9
Condorcet	condorcet	9
Crespyben	crespyben	9
Drezdában	drezdában	9
Dunántúli	dunántúli	9
Dunántúlt	dunántúlt	9
Elcanóval	elcanóval	9
Englandet	englandet	9
Erdéllyel	erdéllyel	9
Erdélyhez	erdélyhez	9
Erdélynek	erdélynek	9
Erdélyről	erdélyről	9
Erdélyért	erdélyért	9
Esterházy	esterházy	9
Esztergom	esztergom	9
Európából	európából	9
Európához	európához	9
Európával	európával	9
Ferdinánd	ferdinánd	9
Floridáig	floridáig	9
Frangepán	frangepán	9
Gazdasági	gazdasági	9
Gibraltár	gibraltár	9
Glinszkij	glinszkij	9
Grúziában	grúziában	9
Guanahani	guanahani	9
Gubernium	gubernium	9
Gutenberg	gutenberg	9
Gyarmatot	gyarmatot	9
Hampshire	hampshire	9
Helvetius	helvetius	9
Henrietta	henrietta	9
Hercegség	hercegség	9
Humájúnra	humájúnra	9
Hódoltság	hódoltság	9
Illésházy	illésházy	9
Iszfahánt	iszfahánt	9
Isztambul	isztambul	9
Itáliában	itáliában	9
Itáliából	itáliából	9
Itáliának	itáliának	9
Izabellát	izabellát	9
Kantonban	kantonban	9
Karintiát	karintiát	9
Kasztília	kasztília	9
Keplerrel	keplerrel	9
Kijáratot	kijáratot	9
Királyság	királyság	9
Kisázsiát	kisázsiát	9
Kolumbiát	kolumbiát	9
Kolumbusz	kolumbusz	9
Koronával	koronával	9
Krisztina	krisztina	9
Károlynak	károlynak	9
Landriano	landriano	9
Lisszabon	lisszabon	9
Lobkowitz	lobkowitz	9
Losonczyt	losonczyt	9
Louisiana	louisiana	9
Lovagrend	lovagrend	9
Luxemburg	luxemburg	9
Marmontel	marmontel	9
Mazzarini	mazzarini	9
Mihállyal	mihállyal	9
Ming-Kína	ming-kína	9
Moldvához	moldvához	9
Moszkvába	moszkvába	9
Nagaszaki	nagaszaki	9
Nagymogul	nagymogul	9
Napkirály	napkirály	9
Nasebynél	nasebynél	9
Nipponnak	nipponnak	9
Norvégiát	norvégiát	9
Nyugathoz	nyugathoz	9
Nyugatról	nyugatról	9
Orsinikat	orsinikat	9
Paraguayt	paraguayt	9
Patyomkin	patyomkin	9
Pigafetta	pigafetta	9
Pireneusi	pireneusi	9
Pompadour	pompadour	9
Potockiak	potockiak	9
Potsdamba	potsdamba	9
Pákozdnál	pákozdnál	9
Raffaello	raffaello	9
Ravaillac	ravaillac	9
Richardot	richardot	9
Richelieu	richelieu	9
Robertson	robertson	9
Rotterdam	rotterdam	9
Sajóládon	sajóládon	9
Savoyának	savoyának	9
Sebastian	sebastian	9
Sebestyén	sebestyén	9
Sevillába	sevillába	9
Skóciában	skóciában	9
Skóciából	skóciából	9
Skóciával	skóciával	9
Speyerben	speyerben	9
Stanzákat	stanzákat	9
Strafford	strafford	9
Struensee	struensee	9
Szaniszló	szaniszló	9
Szapolyai	szapolyai	9
Szardínia	szardínia	9
Szarvason	szarvason	9
Szefevida	szefevida	9
Szentszék	szentszék	9
Szerémség	szerémség	9
Szicíliát	szicíliát	9
Szigetvár	szigetvár	9
Sziléziát	sziléziát	9
Szlavónia	szlavónia	9
Szulejmán	szulejmán	9
Szövetség	szövetség	9
Toledóval	toledóval	9
Toussaint	toussaint	9
Törvények	törvények	9
Veteranit	veteranit	9
Virginiát	virginiát	9
Víziváros	víziváros	9
Álmosdnál	álmosdnál	9
Általános	általános	9
Óvilágból	óvilágból	9
Abukirnál	abukirnál	9
Afrikában	afrikában	9
Aleppóban	aleppóban	9
Algeciras	algeciras	9
Amerikába	amerikába	9
Angliából	angliából	9
Angliához	angliához	9
Angliának	angliának	9
Angliával	angliával	9
Arábiában	arábiában	9
Auerstadt	auerstadt	9
Ausztriát	ausztriát	9
Batthyány	batthyány	9
Benedetti	benedetti	9
Birodalom	birodalom	9
Bonaparte	bonaparte	9
Boulanger	boulanger	9
Bulgáriát	bulgáriát	9
Cavaignac	cavaignac	9
Charlotte	charlotte	9
Condorcet	condorcet	9
Dalmáciát	dalmáciát	9
Dembinski	dembinski	9
Drezdánál	drezdánál	9
Drinápoly	drinápoly	9
Dublinban	dublinban	9
Dumouriez	dumouriez	9
Déroulede	déroulede	9
Ellenzéki	ellenzéki	9
Erdélyből	erdélyből	9
Erdélynek	erdélynek	9
Erzurumot	erzurumot	9
Esterházy	esterházy	9
Európából	európából	9
Európához	európához	9
Európával	európával	9
Ferdinánd	ferdinánd	9
Feuerbach	feuerbach	9
Fouchéval	fouchéval	9
Francisco	francisco	9
Frankfurt	frankfurt	9
Friedland	friedland	9
Friedrich	friedrich	9
Galíciába	galíciába	9
Garibaldi	garibaldi	9
Genovával	genovával	9
Gladstone	gladstone	9
Gorcsakov	gorcsakov	9
Hannoveri	hannoveri	9
Heckenast	heckenast	9
Hetilapot	hetilapot	9
Hitelbank	hitelbank	9
Hohenwart	hohenwart	9
Hollandia	hollandia	9
Home Rule	home rule	9
Homestead	homestead	9
Honvédség	honvédség	9
Huertának	huertának	9
Istvánnak	istvánnak	9
Isztambul	isztambul	9
Itáliából	itáliából	9
Itáliáról	itáliáról	9
Jelszónak	jelszónak	9
Josephine	josephine	9
Kanadának	kanadának	9
Kasgáriát	kasgáriát	9
Kitchener	kitchener	9
Kropotkin	kropotkin	9
Károlyiak	károlyiak	9
Königlich	königlich	9
Kütahyába	kütahyába	9
Lafayette	lafayette	9
Lagardell	lagardell	9
Lamartine	lamartine	9
Lanarkban	lanarkban	9
Lansdowne	lansdowne	9
Lombardia	lombardia	9
Marseille	marseille	9
Mauritius	mauritius	9
Mexikóból	mexikóból	9
Mexikóval	mexikóval	9
Miljutyin	miljutyin	9
Millerand	millerand	9
Moldvában	moldvában	9
Monarchia	monarchia	9
Monroviát	monroviát	9
Moszkvába	moszkvába	9
Munkapárt	munkapárt	9
Mussolini	mussolini	9
Nankingba	nankingba	9
Nankingra	nankingra	9
Nietzsche	nietzsche	9
Novaránál	novaránál	9
Nyugattól	nyugattól	9
Open Door	open door	9
Orosházán	orosházán	9
Parlament	parlament	9
Pecsovics	pecsovics	9
Peschiera	peschiera	9
Pireneusi	pireneusi	9
Politikai	politikai	9
Pákozdnál	pákozdnál	9
Párizsban	párizsban	9
Párizsból	párizsból	9
Reichsrat	reichsrat	9
Reichstag	reichstag	9
Rhodesiát	rhodesiát	9
Rivolinál	rivolinál	9
Saarlouis	saarlouis	9
Salisbury	salisbury	9
Savoyáért	savoyáért	9
Seychelle	seychelle	9
Skóciában	skóciában	9
Smithféle	smithféle	9
Solferino	solferino	9
Szabadság	szabadság	9
Szentírás	szentírás	9
Szerbiába	szerbiába	9
Szingapúr	szingapúr	9
Szisztovo	szisztovo	9
Sztolipin	sztolipin	9
Széchenyi	széchenyi	9
Szíriában	szíriában	9
Szövetség	szövetség	9
Tanulmány	tanulmány	9
Tiszáékat	tiszáékat	9
Torinóban	torinóban	9
Toscanába	toscanába	9
Toussaint	toussaint	9
Trafalgar	trafalgar	9
Trubeckoj	trubeckoj	9
Turgenyev	turgenyev	9
Többségük	többségük	9
Vaucanson	vaucanson	9
Velencére	velencére	9
Venezuela	venezuela	9
Veronában	veronában	9
Védegylet	védegylet	9
Alföldön	alföldön	8
Anonymus	anonymus	8
Ausztria	ausztria	8
Bismarck	bismarck	8
Bizonyos	bizonyos	8
Brigetio	brigetio	8
Budapest	budapest	8
Bukarest	bukarest	8
Bártfára	bártfára	8
Börzsöny	börzsöny	8
Csejtére	csejtére	8
Csernába	csernába	8
Csesznek	csesznek	8
Dorottya	dorottya	8
Dregheol	dregheol	8
Drégelyt	drégelyt	8
Délvidék	délvidék	8
Eberhard	eberhard	8
Ecseggel	ecseggel	8
Erdélyig	erdélyig	8
Erzsébet	erzsébet	8
Eszéknél	eszéknél	8
Európába	európába	8
Feldebrő	feldebrő	8
Felvidék	felvidék	8
Gyöngyös	gyöngyös	8
Gárdonyi	gárdonyi	8
Habsburg	habsburg	8
Hunyadot	hunyadot	8
Hunyadra	hunyadra	8
Ilonának	ilonának	8
Ipolyról	ipolyról	8
Ipolyság	ipolyság	8
Ippolito	ippolito	8
Izabella	izabella	8
Jelentős	jelentős	8
Jeremiás	jeremiás	8
Julianna	julianna	8
Jóllehet	jóllehet	8
Kanizsát	kanizsát	8
Katarina	katarina	8
Katkának	katkának	8
Kazinczy	kazinczy	8
Kincstár	kincstár	8
Klapkáék	klapkáék	8
Kompolti	kompolti	8
Komáromi	komáromi	8
Kárpátok	kárpátok	8
Kérdéses	kérdéses	8
Lehoczyk	lehoczyk	8
Lippánál	lippánál	8
Lovadnál	lovadnál	8
Magasnak	magasnak	8
Magdolna	magdolna	8
Makovica	makovica	8
Martuzán	martuzán	8
Murányba	murányba	8
Napóleon	napóleon	8
Nebojsza	nebojsza	8
Pannonia	pannonia	8
Pannónia	pannónia	8
Párizsba	párizsba	8
Radulnak	radulnak	8
Ráadásul	ráadásul	8
Révaynak	révaynak	8
Rózsához	rózsához	8
Siklóson	siklóson	8
Soklyósi	soklyósi	8
Szentély	szentély	8
Szilágyi	szilágyi	8
Szilézia	szilézia	8
Szávától	szávától	8
Szécsény	szécsény	8
Temesvár	temesvár	8
Thuróczi	thuróczi	8
Torinóba	torinóba	8
Torinóra	torinóra	8
Vagabund	vagabund	8
Vereckei	vereckei	8
Veszprém	veszprém	8
Visegrád	visegrád	8
Vladimír	vladimír	8
Vágvonal	vágvonal	8
Windisch	windisch	8
Zsigmond	zsigmond	8
Összesen	összesen	8
Őfelsége	őfelsége	8
Afrikába	afrikába	8
Alberoni	alberoni	8
Alekszej	alekszej	8
Angliába	angliába	8
Angliája	angliája	8
Angliára	angliára	8
Angliáét	angliáét	8
Aragónia	aragónia	8
Ausztria	ausztria	8
Bagdadot	bagdadot	8
Balkánon	balkánon	8
Baselben	baselben	8
Bastille	bastille	8
Brahéval	brahéval	8
Bramante	bramante	8
Burgoyne	burgoyne	8
Ceylonba	ceylonba	8
Colonnák	colonnák	8
Cromwell	cromwell	8
Damanban	damanban	8
Debrecen	debrecen	8
Dekkánon	dekkánon	8
Delaware	delaware	8
Dimitrij	dimitrij	8
Dolhánál	dolhánál	8
Drávától	drávától	8
Drégelyt	drégelyt	8
Dániában	dániában	8
Dániának	dániának	8
Dániával	dániával	8
Egmontot	egmontot	8
Erdélyen	erdélyen	8
Erdélyre	erdélyre	8
Erzsébet	erzsébet	8
Eszéknél	eszéknél	8
Európába	európába	8
Európára	európára	8
Európáét	európáét	8
Fehérvár	fehérvár	8
Felvidék	felvidék	8
Fernando	fernando	8
Floridát	floridát	8
Friedell	friedell	8
Földközi	földközi	8
Galíciát	galíciát	8
Grodnóba	grodnóba	8
Gyaluban	gyaluban	8
Györgyöt	györgyöt	8
Habsburg	habsburg	8
Hannover	hannover	8
Hanzától	hanzától	8
Harmadik	harmadik	8
Hidejosi	hidejosi	8
Hollókőt	hollókőt	8
Holstein	holstein	8
Indiából	indiából	8
Industól	industól	8
Itáliára	itáliára	8
Izabella	izabella	8
Izlandot	izlandot	8
Jánossal	jánossal	8
Kairóból	kairóból	8
Kamakura	kamakura	8
Kanizsát	kanizsát	8
Kantonon	kantonon	8
Karasica	karasica	8
Karlócán	karlócán	8
Kaukázus	kaukázus	8
Kelettel	kelettel	8
Koreával	koreával	8
Krisztus	krisztus	8
Kánságot	kánságot	8
Leibnitz	leibnitz	8
Leonardo	leonardo	8
Lepantói	lepantói	8
Liangsan	liangsan	8
Lilburne	lilburne	8
Litvánia	litvánia	8
Magellán	magellán	8
Maryland	maryland	8
Mediciek	mediciek	8
Mensikov	mensikov	8
Mestával	mestával	8
Miksának	miksának	8
Miksánál	miksánál	8
Moldvára	moldvára	8
Mongólia	mongólia	8
Montcalm	montcalm	8
Montreal	montreal	8
Moszkvát	moszkvát	8
Musztafa	musztafa	8
Máriának	máriának	8
Móricnak	móricnak	8
Mühlberg	mühlberg	8
Narvánál	narvánál	8
Navarrai	navarrai	8
Nemzetek	nemzetek	8
Nihonnak	nihonnak	8
Nizzában	nizzában	8
Nobunaga	nobunaga	8
Nyugaton	nyugaton	8
Nyugatra	nyugatra	8
Oderával	oderával	8
Olivarez	olivarez	8
Pamplona	pamplona	8
Perzsiát	perzsiát	8
Piacenza	piacenza	8
Podóliát	podóliát	8
Poitiers	poitiers	8
Portához	portához	8
Portáról	portáról	8
Portával	portával	8
Pugacsov	pugacsov	8
Párkányt	párkányt	8
Péternél	péternél	8
Péterrel	péterrel	8
Quebecet	quebecet	8
Rochelle	rochelle	8
Rousseau	rousseau	8
Ráadásul	ráadásul	8
Sanlúcar	sanlúcar	8
Solymost	solymost	8
Sorbonne	sorbonne	8
Sujszkij	sujszkij	8
Szabolcs	szabolcs	8
Szenátus	szenátus	8
Szerbiát	szerbiát	8
Szibéria	szibéria	8
Szicília	szicília	8
Szilézia	szilézia	8
Szuvorov	szuvorov	8
Szíriára	szíriára	8
Tahmaszp	tahmaszp	8
Temesköz	temesköz	8
Temesvár	temesvár	8
Teréziát	teréziát	8
Thökölyt	thökölyt	8
Tojotomi	tojotomi	8
Tokajnál	tokajnál	8
Tállyára	tállyára	8
Társaság	társaság	8
Ukrajnát	ukrajnát	8
Varsóban	varsóban	8
Vassyban	vassyban	8
Vaszilij	vaszilij	8
Vatikánt	vatikánt	8
Velencét	velencét	8
Victoria	victoria	8
Világost	világost	8
Voltaire	voltaire	8
Wartburg	wartburg	8
Welserek	welserek	8
Werbőczy	werbőczy	8
Yorktown	yorktown	8
Zamojski	zamojski	8
Zamoyski	zamoyski	8
Zentánál	zentánál	8
Zsibónál	zsibónál	8
Zsigmond	zsigmond	8
Írország	írország	8
Akadémia	akadémia	8
Albrecht	albrecht	8
Algériát	algériát	8
Angliába	angliába	8
Ausztria	ausztria	8
Badenben	badenben	8
Bakunyin	bakunyin	8
Balkánra	balkánra	8
Balközép	balközép	8
Baltikum	baltikum	8
Bastille	bastille	8
Belcredi	belcredi	8
Bernardo	bernardo	8
Bernhard	bernhard	8
Bismarck	bismarck	8
Bolíviát	bolíviát	8
Bordeaux	bordeaux	8
Boszniát	boszniát	8
Bravótól	bravótól	8
Brazília	brazília	8
Brüsszel	brüsszel	8
Budapest	budapest	8
Bulgária	bulgária	8
Carranza	carranza	8
Chambord	chambord	8
Cisalpin	cisalpin	8
Commerce	commerce	8
Concorde	concorde	8
Csillaga	csillaga	8
Cádizban	cádizban	8
Dalmácia	dalmácia	8
Delcassé	delcassé	8
Disraeli	disraeli	8
Drezdába	drezdába	8
Dzsiddát	dzsiddát	8
Dániával	dániával	8
Ecuadort	ecuadort	8
Egyiptom	egyiptom	8
Egyletet	egyletet	8
Electric	electric	8
Emellett	emellett	8
Erdélyre	erdélyre	8
Erzsébet	erzsébet	8
Európába	európába	8
Európára	európára	8
Ferrarát	ferrarát	8
Floridát	floridát	8
Friedell	friedell	8
Földközi	földközi	8
Fülöpnek	fülöpnek	8
Gambetta	gambetta	8
Geringer	geringer	8
Gioberti	gioberti	8
Giolitti	giolitti	8
Gothában	gothában	8
Guyanába	guyanába	8
Générale	générale	8
Habsburg	habsburg	8
Hausmann	hausmann	8
Himnusza	himnusza	8
Hitelnek	hitelnek	8
Holstein	holstein	8
Hongkong	hongkong	8
Ignatyev	ignatyev	8
Istentől	istentől	8
Itáliába	itáliába	8
Itáliára	itáliára	8
Jangcéig	jangcéig	8
Jelasics	jelasics	8
Jemappes	jemappes	8
Kansasba	kansasba	8
Kaukázus	kaukázus	8
Kazinczy	kazinczy	8
Ketteler	ketteler	8
Kolowrat	kolowrat	8
Kolumbia	kolumbia	8
Krétáért	krétáért	8
Lachaise	lachaise	8
Landerer	landerer	8
Landwehr	landwehr	8
Lassalle	lassalle	8
Liguriai	liguriai	8
Lissánál	lissánál	8
Lovakrul	lovakrul	8
Macuhito	macuhito	8
Majnától	majnától	8
Marchand	marchand	8
Mensikov	mensikov	8
Miksának	miksának	8
Mirabeau	mirabeau	8
Missouri	missouri	8
Moniteur	moniteur	8
Moreában	moreában	8
Mészáros	mészáros	8
Napoleon	napoleon	8
Napóleon	napóleon	8
National	national	8
Navarino	navarino	8
Nebraska	nebraska	8
Nizzáért	nizzáért	8
Nyugaton	nyugaton	8
Nyugatot	nyugatot	8
Olmützbe	olmützbe	8
Országos	országos	8
Ostennek	ostennek	8
Paraguay	paraguay	8
Parnellt	parnellt	8
Pesztyel	pesztyel	8
Plehanov	plehanov	8
Polignac	polignac	8
Portának	portának	8
Portánál	portánál	8
Priamosz	priamosz	8
Proudhon	proudhon	8
Párizsig	párizsig	8
Párizsra	párizsra	8
Pétervár	pétervár	8
Radetzky	radetzky	8
Radowitz	radowitz	8
Rajnától	rajnától	8
Rauscher	rauscher	8
Rhodésia	rhodésia	8
Rousseau	rousseau	8
Rádaynak	rádaynak	8
Sevirjov	sevirjov	8
Sinopnál	sinopnál	8
Standard	standard	8
Stefánia	stefánia	8
Szerbiát	szerbiát	8
Szicília	szicília	8
Sziámban	sziámban	8
Szuvorov	szuvorov	8
Szíriára	szíriára	8
Taglalat	taglalat	8
Tanzimát	tanzimát	8
Tecumseh	tecumseh	8
Temesvár	temesvár	8
Theobald	theobald	8
Tizenkét	tizenkét	8
Todleben	todleben	8
Tokugava	tokugava	8
Tolsztoj	tolsztoj	8
Trencsén	trencsén	8
Tuniszra	tuniszra	8
Tunéziát	tunéziát	8
Társaság	társaság	8
Valmynál	valmynál	8
Varsóban	varsóban	8
Varsóért	varsóért	8
Veracruz	veracruz	8
Viktória	viktória	8
Villának	villának	8
Vérmezőn	vérmezőn	8
Walewska	walewska	8
Walewski	walewski	8
Waterloo	waterloo	8
Zágrábba	zágrábba	8
Ázsiában	ázsiában	8
Írország	írország	8
Adriáig	adriáig	7
Almáson	almáson	7
Annyira	annyira	7
Annának	annának	7
Annával	annával	7
Atlamos	atlamos	7
Azonban	azonban	7
Babócsa	babócsa	7
Balassi	balassi	7
Baranya	baranya	7
Beatrix	beatrix	7
Becsüld	becsüld	7
Belgrád	belgrád	7
Bethlen	bethlen	7
Bocskai	bocskai	7
Bosznia	bosznia	7
Bottyán	bottyán	7
Brudern	brudern	7
Budáról	budáról	7
Báthory	báthory	7
Bécsben	bécsben	7
Béthune	béthune	7
Caprara	caprara	7
Caraffa	caraffa	7
Cserhát	cserhát	7
Csórich	csórich	7
Demeter	demeter	7
Dragoly	dragoly	7
Drágely	drágely	7
Drégelt	drégelt	7
Drégely	drégely	7
Dunához	dunához	7
Egerből	egerből	7
Egerhez	egerhez	7
Egernek	egernek	7
Egyszer	egyszer	7
Egészen	egészen	7
Ejtsünk	ejtsünk	7
Erazmus	erazmus	7
Erdélyt	erdélyt	7
Európát	európát	7
Ezekben	ezekben	7
Fogaras	fogaras	7
Frigyes	frigyes	7
Galícia	galícia	7
Garaiak	garaiak	7
Genfben	genfben	7
Gergely	gergely	7
Geszthy	geszthy	7
Gizella	gizella	7
Gézának	gézának	7
Görgeyt	görgeyt	7
Hamvait	hamvait	7
Hasszán	hasszán	7
Heisler	heisler	7
Heister	heister	7
Hollókő	hollókő	7
Hátszeg	hátszeg	7
Ilonára	ilonára	7
Imrének	imrének	7
Jagelló	jagelló	7
Kacsics	kacsics	7
Kanizsa	kanizsa	7
Kassics	kassics	7
Kassára	kassára	7
Kincses	kincses	7
Kinizsi	kinizsi	7
Kisnána	kisnána	7
Klapkát	klapkát	7
Komarno	komarno	7
Kompolt	kompolt	7
Komárom	komárom	7
Kossuth	kossuth	7
Kristóf	kristóf	7
Kudlich	kudlich	7
Kínában	kínában	7
Könyvek	könyvek	7
Körmend	körmend	7
Lambert	lambert	7
Lapincs	lapincs	7
Latorca	latorca	7
Libardy	libardy	7
Lillith	lillith	7
Madonna	madonna	7
Magócsi	magócsi	7
Mekcsey	mekcsey	7
Mertzet	mertzet	7
Mezőssy	mezőssy	7
Mielőtt	mielőtt	7
Mocsáig	mocsáig	7
Mohamed	mohamed	7
Moravka	moravka	7
Munkács	munkács	7
Március	március	7
Nyugati	nyugati	7
Nádasdy	nádasdy	7
Október	október	7
Omoneus	omoneus	7
Orczyak	orczyak	7
Országh	országh	7
Perczel	perczel	7
Perényi	perényi	7
Pestről	pestről	7
Pozsony	pozsony	7
Pöstyén	pöstyén	7
Richárd	richárd	7
Románia	románia	7
Rozsály	rozsály	7
Ruszkán	ruszkán	7
Rusztem	rusztem	7
Rákóczi	rákóczi	7
Sirokot	sirokot	7
Somoskő	somoskő	7
Soproni	soproni	7
Steindl	steindl	7
Szabács	szabács	7
Szemere	szemere	7
Szigeti	szigeti	7
Sziszek	sziszek	7
Szolnok	szolnok	7
Szörény	szörény	7
Sárkány	sárkány	7
Sírjára	sírjára	7
Terézia	terézia	7
Teuffel	teuffel	7
Thököly	thököly	7
Tivadar	tivadar	7
Trigell	trigell	7
Tótnána	tótnána	7
Uherska	uherska	7
Ulászló	ulászló	7
Ungaria	ungaria	7
Valóban	valóban	7
Varsóba	varsóba	7
Váradot	váradot	7
Várhegy	várhegy	7
Várkony	várkony	7
Végvári	végvári	7
Youtube	youtube	7
Zemplén	zemplén	7
Zápolya	zápolya	7
Április	április	7
Építési	építési	7
Öregvár	öregvár	7
Ötszögű	ötszögű	7
Újszőny	újszőny	7
Afrikát	afrikát	7
Agrában	agrában	7
Amerika	amerika	7
Anglián	anglián	7
Angliát	angliát	7
Annával	annával	7
Article	article	7
Arábián	arábián	7
Asikaga	asikaga	7
Atlanti	atlanti	7
Austria	austria	7
Bahamák	bahamák	7
Balaton	balaton	7
Baleári	baleári	7
Barcsay	barcsay	7
Beatrix	beatrix	7
Belgium	belgium	7
Belgrád	belgrád	7
Berlint	berlint	7
Bethlen	bethlen	7
Biblián	biblián	7
Bibliát	bibliát	7
Bocskai	bocskai	7
Borgiák	borgiák	7
Bourbon	bourbon	7
Budáról	budáról	7
Bujákot	bujákot	7
Busbeck	busbeck	7
Báthori	báthori	7
Béccsel	béccsel	7
Calonne	calonne	7
Cambrai	cambrai	7
Candide	candide	7
Canossa	canossa	7
Cebuban	cebuban	7
Cellini	cellini	7
Ciprust	ciprust	7
Colbert	colbert	7
Coligny	coligny	7
Cranmer	cranmer	7
Csendes	csendes	7
Diderot	diderot	7
Dnyeper	dnyeper	7
Drezdát	drezdát	7
Dzsahán	dzsahán	7
Dzsáhán	dzsáhán	7
Emánuel	emánuel	7
Erdélyi	erdélyi	7
Erdélyt	erdélyt	7
Etiópia	etiópia	7
Európán	európán	7
Európát	európát	7
Fayette	fayette	7
Fergana	fergana	7
Florida	florida	7
Forgách	forgách	7
Francia	francia	7
Frigyes	frigyes	7
Fénelon	fénelon	7
Füleket	füleket	7
Galícia	galícia	7
Gellért	gellért	7
Gentben	gentben	7
Georgia	georgia	7
Gergely	gergely	7
Germain	germain	7
Granada	granada	7
Grúziát	grúziát	7
Gusztáv	gusztáv	7
Hadrián	hadrián	7
Hampden	hampden	7
Heister	heister	7
Holbach	holbach	7
Holland	holland	7
Hormuzt	hormuzt	7
Hunyadi	hunyadi	7
Ibrahim	ibrahim	7
Iejaszu	iejaszu	7
Imréhez	imréhez	7
Indiába	indiába	7
Indiáig	indiáig	7
Indonéz	indonéz	7
Iszmail	iszmail	7
Itáliát	itáliát	7
Jagelló	jagelló	7
Jozefát	jozefát	7
Kalikut	kalikut	7
Kamarán	kamarán	7
Kanadát	kanadát	7
Kanizsa	kanizsa	7
Katalin	katalin	7
Kaunitz	kaunitz	7
Kazányi	kazányi	7
Keletet	keletet	7
Kinizsi	kinizsi	7
Királyi	királyi	7
Klissza	klissza	7
Komárom	komárom	7
Koreába	koreába	7
Kristóf	kristóf	7
Károlyt	károlyt	7
Kínának	kínának	7
Köprülü	köprülü	7
Lehmann	lehmann	7
Louvois	louvois	7
Luzonba	luzonba	7
Lyonban	lyonban	7
Macaura	macaura	7
Makarij	makarij	7
Malabar	malabar	7
Matthys	matthys	7
Mazarin	mazarin	7
Mercier	mercier	7
Mettrie	mettrie	7
Mohamed	mohamed	7
Moldvát	moldvát	7
Munkács	munkács	7
Második	második	7
Münnich	münnich	7
Münster	münster	7
Nanking	nanking	7
Niccoló	niccoló	7
Nádasdy	nádasdy	7
Ocskayé	ocskayé	7
Ontario	ontario	7
Orinoco	orinoco	7
Orléans	orléans	7
Orániai	orániai	7
Osztrák	osztrák	7
Padilla	padilla	7
Palotát	palotát	7
Partium	partium	7
Perouse	perouse	7
Perzsia	perzsia	7
Piemont	piemont	7
Plassey	plassey	7
Platónt	platónt	7
Portára	portára	7
Pozsony	pozsony	7
Prágába	prágába	7
Quesnay	quesnay	7
Rabutin	rabutin	7
Reniger	reniger	7
Rhodosz	rhodosz	7
Rákóczi	rákóczi	7
Rómával	rómával	7
Savoyát	savoyát	7
Sevilla	sevilla	7
Sidonia	sidonia	7
Sixtusi	sixtusi	7
Skóciát	skóciát	7
Spanyol	spanyol	7
Steuben	steuben	7
Swieten	swieten	7
Szabács	szabács	7
Szatmár	szatmár	7
Szerbia	szerbia	7
Sziszek	sziszek	7
Szolnok	szolnok	7
Terézia	terézia	7
Thurzók	thurzók	7
Thököly	thököly	7
Tokajba	tokajba	7
Toscana	toscana	7
További	további	7
Trident	trident	7
Ukrajna	ukrajna	7
Ulászló	ulászló	7
Vatikán	vatikán	7
Velence	velence	7
Walpole	walpole	7
Yucatán	yucatán	7
Zeeland	zeeland	7
Zsófiát	zsófiát	7
Álvares	álvares	7
Ázsiába	ázsiába	7
Újvilág	újvilág	7
Afrikát	afrikát	7
Aladdin	aladdin	7
Albánia	albánia	7
Alpokig	alpokig	7
Amerika	amerika	7
Andokon	andokon	7
Angliát	angliát	7
Annamra	annamra	7
Antonio	antonio	7
Arábiát	arábiát	7
Atacama	atacama	7
Atlanti	atlanti	7
Azoknak	azoknak	7
Balfour	balfour	7
Balkánt	balkánt	7
Bazaine	bazaine	7
Belgium	belgium	7
Belgrád	belgrád	7
Benedek	benedek	7
Blanqui	blanqui	7
Blücher	blücher	7
Bolívar	bolívar	7
Bosznia	bosznia	7
Bourbon	bourbon	7
Canning	canning	7
Caprivi	caprivi	7
Crispit	crispit	7
Csemegi	csemegi	7
Csendes	csendes	7
Daimler	daimler	7
Dickens	dickens	7
Dreyfus	dreyfus	7
Dreyser	dreyser	7
Décazes	décazes	7
Emánuel	emánuel	7
England	england	7
Eperjes	eperjes	7
Epirusz	epirusz	7
Erdélyt	erdélyt	7
Eugénie	eugénie	7
Európán	európán	7
Európát	európát	7
Ezáltal	ezáltal	7
Felelet	felelet	7
Ferrara	ferrara	7
Firenze	firenze	7
Fokföld	fokföld	7
Fourier	fourier	7
Francia	francia	7
Frankel	frankel	7
Frigyes	frigyes	7
Galilei	galilei	7
Galícia	galícia	7
Genfben	genfben	7
Gironde	gironde	7
Gusztáv	gusztáv	7
Győrnél	győrnél	7
Hajrije	hajrije	7
Harmony	harmony	7
Hofburg	hofburg	7
Houston	houston	7
Hyndman	hyndman	7
Ibériai	ibériai	7
Indiába	indiába	7
Indiáig	indiáig	7
Istvánt	istvánt	7
Itáliát	itáliát	7
Jangcén	jangcén	7
Katonai	katonai	7
Kaunitz	kaunitz	7
Kilikia	kilikia	7
Klapkát	klapkát	7
Komárom	komárom	7
Konvent	konvent	7
Konyáig	konyáig	7
Kossuth	kossuth	7
Krímben	krímben	7
Kutuzov	kutuzov	7
Kálnoky	kálnoky	7
Károlyt	károlyt	7
Kínában	kínában	7
Kínához	kínához	7
Kínával	kínával	7
Landtag	landtag	7
Lincoln	lincoln	7
Linzben	linzben	7
Ludevit	ludevit	7
Lyonban	lyonban	7
Magenta	magenta	7
Mainban	mainban	7
Mantova	mantova	7
Marokkó	marokkó	7
Mazzini	mazzini	7
Medinát	medinát	7
Medzsid	medzsid	7
Meidzsi	meidzsi	7
Mexikót	mexikót	7
Mohamed	mohamed	7
Moldvát	moldvát	7
Montijo	montijo	7
Márvány	márvány	7
Nahimov	nahimov	7
Nemzeti	nemzeti	7
Novarum	novarum	7
Néppárt	néppárt	7
Növekvő	növekvő	7
Ohranát	ohranát	7
Ontario	ontario	7
Palacky	palacky	7
Panther	panther	7
Partium	partium	7
Perczel	perczel	7
Perzsia	perzsia	7
Piemont	piemont	7
Portára	portára	7
Poznant	poznant	7
Pozsony	pozsony	7
Prágába	prágába	7
Párizst	párizst	7
Pármába	pármába	7
Quebeck	quebeck	7
Rhodosz	rhodosz	7
Romagna	romagna	7
Romanov	romanov	7
Románia	románia	7
Réforme	réforme	7
Savoyát	savoyát	7
Schlick	schlick	7
Sherman	sherman	7
Spanyol	spanyol	7
Stefanó	stefanó	7
Stádium	stádium	7
Szahara	szahara	7
Szapáry	szapáry	7
Szatmár	szatmár	7
Szerbia	szerbia	7
Taaffét	taaffét	7
Teremtő	teremtő	7
Tirpitz	tirpitz	7
Togóban	togóban	7
Toscana	toscana	7
Travail	travail	7
Trieszt	trieszt	7
Trákiát	trákiát	7
Tuniszt	tuniszt	7
Ugandát	ugandát	7
Vasvári	vasvári	7
Velence	velence	7
Villele	villele	7
Wekerle	wekerle	7
Wrangel	wrangel	7
Zichyek	zichyek	7
Ágoston	ágoston	7
Államok	államok	7
Ázsiára	ázsiára	7
Északot	északot	7
Északra	északra	7
Adriai	adriai	6
Aeneás	aeneás	6
Albert	albert	6
Aligha	aligha	6
Alihoz	alihoz	6
Amikor	amikor	6
András	andrás	6
Anyósa	anyósa	6
Arnold	arnold	6
Auróra	auróra	6
Bakony	bakony	6
Bakócz	bakócz	6
Balkán	balkán	6
Biblia	biblia	6
Bolyki	bolyki	6
Borban	borban	6
Budára	budára	6
Bálint	bálint	6
Bécset	bécset	6
Cavour	cavour	6
Ceczey	ceczey	6
Csanád	csanád	6
Csejte	csejte	6
Cserna	cserna	6
Cserép	cserép	6
Csurgó	csurgó	6
Csécse	csécse	6
Decius	decius	6
Drágul	drágul	6
Drégel	drégel	6
Dévára	dévára	6
Egerbe	egerbe	6
Egerre	egerre	6
Ehenyk	ehenyk	6
Erdély	erdély	6
Európa	európa	6
Ezután	ezután	6
Fekete	fekete	6
Ferenc	ferenc	6
Giskra	giskra	6
Gyulán	gyulán	6
György	györgy	6
Gönyűn	gönyűn	6
Görgey	görgey	6
Haller	haller	6
Halála	halála	6
Hatvan	hatvan	6
Haynau	haynau	6
Henrik	henrik	6
Hernád	hernád	6
Hubiár	hubiár	6
Hunyad	hunyad	6
Huszár	huszár	6
Hídvég	hídvég	6
Hűsége	hűsége	6
Idővel	idővel	6
Igmánd	igmánd	6
Illava	illava	6
Ilonát	ilonát	6
István	istván	6
Jajcát	jajcát	6
József	józsef	6
Június	június	6
Kamara	kamara	6
Kassán	kassán	6
Keleti	keleti	6
Klapka	klapka	6
Kodály	kodály	6
Koháry	koháry	6
Komoly	komoly	6
Kopasz	kopasz	6
Korona	korona	6
Károly	károly	6
Kárpát	kárpát	6
Kászim	kászim	6
Kázmér	kázmér	6
Később	később	6
Kövess	kövess	6
Közben	közben	6
Kőszeg	kőszeg	6
Kőszűz	kőszűz	6
László	lászló	6
Margit	margit	6
Mehmed	mehmed	6
Mihály	mihály	6
Miklós	miklós	6
Milyen	milyen	6
Miután	miután	6
Mohács	mohács	6
Mulykó	mulykó	6
Mátrát	mátrát	6
Mátyás	mátyás	6
Nostra	nostra	6
Nyitra	nyitra	6
Nánára	nánára	6
Nógrád	nógrád	6
Palánk	palánk	6
Pesten	pesten	6
Pestre	pestre	6
Préste	préste	6
Pyrker	pyrker	6
Pásztó	pásztó	6
Reggel	reggel	6
Rudolf	rudolf	6
Ruszka	ruszka	6
Róbert	róbert	6
Sajnos	sajnos	6
Schlik	schlik	6
Siklós	siklós	6
Sixtus	sixtus	6
Somogy	somogy	6
Stibor	stibor	6
Suisse	suisse	6
Szanda	szanda	6
Szeged	szeged	6
Szinán	szinán	6
Szondy	szondy	6
Száván	száván	6
Ságról	ságról	6
Sámuel	sámuel	6
Sándor	sándor	6
Sárvár	sárvár	6
Tarcal	tarcal	6
Teltek	teltek	6
Tenkes	tenkes	6
Teufel	teufel	6
Thurzó	thurzó	6
Tinódi	tinódi	6
Tiszán	tiszán	6
Tomori	tomori	6
Topord	topord	6
Tábori	tábori	6
Tömlöc	tömlöc	6
Ugocsa	ugocsa	6
Ungvár	ungvár	6
Ursula	ursula	6
Valide	valide	6
Vauban	vauban	6
Vedano	vedano	6
Várdai	várdai	6
Várday	várday	6
Vérfok	vérfok	6
Walter	walter	6
Welden	welden	6
Zalasd	zalasd	6
Zimony	zimony	6
Zrínyi	zrínyi	6
Zsitva	zsitva	6
Zsófia	zsófia	6
Évának	évának	6
Őrhegy	őrhegy	6
Adriai	adriai	6
Afrika	afrika	6
Akbart	akbart	6
Albert	albert	6
Alföld	alföld	6
András	andrás	6
Anglia	anglia	6
Aradot	aradot	6
Aranda	aranda	6
Armada	armada	6
Arthur	arthur	6
Attila	attila	6
Azovot	azovot	6
Bahama	bahama	6
Bakócz	bakócz	6
Bengál	bengál	6
Bercis	bercis	6
Biblia	biblia	6
Bizánc	bizánc	6
Bodrog	bodrog	6
Borgia	borgia	6
Boston	boston	6
Brassó	brassó	6
Brezán	brezán	6
Budára	budára	6
Calais	calais	6
Carlos	carlos	6
Ceutát	ceutát	6
Chilét	chilét	6
Common	common	6
Corpus	corpus	6
Cortes	cortes	6
Delhit	delhit	6
Diuban	diuban	6
Dráván	dráván	6
Dubois	dubois	6
Edward	edward	6
Edóban	edóban	6
Elcano	elcano	6
Elzász	elzász	6
Emberi	emberi	6
Erdély	erdély	6
Európa	európa	6
Fekete	fekete	6
Ferenc	ferenc	6
Fiának	fiának	6
Fjodor	fjodor	6
Fleury	fleury	6
Fronde	fronde	6
Fugger	fugger	6
Földet	földet	6
Földön	földön	6
Fűszer	fűszer	6
Genfbe	genfbe	6
Genova	genova	6
Ghiraj	ghiraj	6
Gordon	gordon	6
Goában	goában	6
Gritti	gritti	6
Gyulát	gyulát	6
György	györgy	6
Haszán	haszán	6
Hatvan	hatvan	6
Haydnt	haydnt	6
Henrik	henrik	6
Herder	herder	6
Hosius	hosius	6
Hudson	hudson	6
Hurrem	hurrem	6
Ilonát	ilonát	6
Indiát	indiát	6
Island	island	6
István	istván	6
Itália	itália	6
Jangce	jangce	6
Jermak	jermak	6
Jersey	jersey	6
Julián	julián	6
Jánost	jánost	6
József	józsef	6
Kabult	kabult	6
Kamara	kamara	6
Kanada	kanada	6
Kassán	kassán	6
Kassát	kassát	6
Kaszpi	kaszpi	6
Kemény	kemény	6
Kereki	kereki	6
Khlesl	khlesl	6
Kloska	kloska	6
Koreát	koreát	6
Korona	korona	6
Krakkó	krakkó	6
Krétát	krétát	6
Krímbe	krímbe	6
Krímet	krímet	6
Kubány	kubány	6
Kálvin	kálvin	6
Károly	károly	6
Kászim	kászim	6
Kázmér	kázmér	6
Kínába	kínába	6
Kőszeg	kőszeg	6
Lajtán	lajtán	6
Lefort	lefort	6
Linzbe	linzbe	6
Lippát	lippát	6
London	london	6
Lordok	lordok	6
Loyola	loyola	6
Luther	luther	6
Lützen	lützen	6
Lőrinc	lőrinc	6
Madame	madame	6
Madrid	madrid	6
Magyar	magyar	6
Manche	manche	6
Margit	margit	6
Medina	medina	6
Mehmed	mehmed	6
Mestát	mestát	6
Mihály	mihály	6
Miklós	miklós	6
Miksát	miksát	6
Milánó	milánó	6
Mindez	mindez	6
Mingek	mingek	6
Modena	modena	6
Mohács	mohács	6
Moldva	moldva	6
Mozart	mozart	6
Máriát	máriát	6
Mátyás	mátyás	6
Münzer	münzer	6
Necker	necker	6
Newton	newton	6
Niklas	niklas	6
Nizzát	nizzát	6
Nyikon	nyikon	6
Nyugat	nyugat	6
Nápoly	nápoly	6
Nógrád	nógrád	6
Oppeln	oppeln	6
Peking	peking	6
Pertav	pertav	6
Perzsa	perzsa	6
Pombal	pombal	6
Porosz	porosz	6
Portán	portán	6
Prince	prince	6
Pálffy	pálffy	6
Párizs	párizs	6
Pétert	pétert	6
Rights	rights	6
Rudolf	rudolf	6
Rómába	rómába	6
Savoya	savoya	6
Sforza	sforza	6
Skócia	skócia	6
Sophie	sophie	6
Sopron	sopron	6
Stuart	stuart	6
Szeben	szeben	6
Szeged	szeged	6
Szelim	szelim	6
Szinán	szinán	6
Száván	száván	6
Szíria	szíria	6
Sándor	sándor	6
Tajvan	tajvan	6
Tanács	tanács	6
Tebriz	tebriz	6
Tirolt	tirolt	6
Tiszán	tiszán	6
Tokajt	tokajt	6
Toledo	toledo	6
Tolnán	tolnán	6
Tomori	tomori	6
Tordán	tordán	6
Turgot	turgot	6
Táblát	táblát	6
Udvari	udvari	6
Ugocsa	ugocsa	6
Valois	valois	6
Varsót	varsót	6
Vilmos	vilmos	6
Wyclif	wyclif	6
Xavéri	xavéri	6
Zrínyi	zrínyi	6
Zsitva	zsitva	6
Ádenbe	ádenbe	6
Északi	északi	6
MARTOS	martos	6
Adriai	adriai	6
Afrika	afrika	6
Agadir	agadir	6
Albert	albert	6
Alföld	alföld	6
Alival	alival	6
Alpári	alpári	6
Amitől	amitől	6
András	andrás	6
Anglia	anglia	6
Attila	attila	6
Babeuf	babeuf	6
Bagdad	bagdad	6
Balkán	balkán	6
Barras	barras	6
Batumi	batumi	6
Berlin	berlin	6
Bombay	bombay	6
Budára	budára	6
Bánffy	bánffy	6
Caesar	caesar	6
Cambon	cambon	6
Canada	canada	6
Carlos	carlos	6
Carnot	carnot	6
Cavour	cavour	6
Ceylon	ceylon	6
Ciprus	ciprus	6
Cobden	cobden	6
Conrad	conrad	6
Corday	corday	6
Csepel	csepel	6
Curzon	curzon	6
Custer	custer	6
Daniel	daniel	6
Danton	danton	6
Darboy	darboy	6
Darwin	darwin	6
Deákék	deákék	6
Donyec	donyec	6
Drávát	drávát	6
Dunáig	dunáig	6
Dániel	dániel	6
Dániát	dániát	6
Délhez	délhez	6
Elzász	elzász	6
Emberi	emberi	6
Emsben	emsben	6
Engels	engels	6
Erdély	erdély	6
Európa	európa	6
Ezután	ezután	6
Eötvös	eötvös	6
Fekete	fekete	6
Ferenc	ferenc	6
Guizot	guizot	6
György	györgy	6
Görgey	görgey	6
Haynau	haynau	6
Helvét	helvét	6
Hentzi	hentzi	6
Herzen	herzen	6
Hitelt	hitelt	6
Huerta	huerta	6
Hébert	hébert	6
Hírlap	hírlap	6
Hübner	hübner	6
Igazak	igazak	6
Indiát	indiát	6
Irakra	irakra	6
István	istván	6
Itália	itália	6
Julius	julius	6
Juárez	juárez	6
József	józsef	6
Kairót	kairót	6
Kanada	kanada	6
Keleti	keleti	6
Kempen	kempen	6
Klapka	klapka	6
Kollár	kollár	6
Kommün	kommün	6
Krétát	krétát	6
Krüger	krüger	6
Kálmán	kálmán	6
Károly	károly	6
Kázmér	kázmér	6
Kínára	kínára	6
Körrel	körrel	6
Kübeck	kübeck	6
Lajtán	lajtán	6
Latour	latour	6
Little	little	6
London	london	6
László	lászló	6
Lónyay	lónyay	6
Madero	madero	6
Madrid	madrid	6
Malawi	malawi	6
Martín	martín	6
Maupas	maupas	6
Mekkát	mekkát	6
Mexikó	mexikó	6
Mihály	mihály	6
Miklós	miklós	6
Miksát	miksát	6
Milánó	milánó	6
Mindez	mindez	6
Modena	modena	6
Moldva	moldva	6
Monroe	monroe	6
Mukden	mukden	6
Máltát	máltát	6
Mátyás	mátyás	6
Mórnál	mórnál	6
Múzeum	múzeum	6
Nelson	nelson	6
Nyugat	nyugat	6
Nápoly	nápoly	6
Oregon	oregon	6
Orsini	orsini	6
Orsova	orsova	6
Oszkár	oszkár	6
Panama	panama	6
Parmát	parmát	6
Paulus	paulus	6
Paxton	paxton	6
Peking	peking	6
Perzsa	perzsa	6
Pestre	pestre	6
Philip	philip	6
Pilvax	pilvax	6
Plevna	plevna	6
Portát	portát	6
Puerto	puerto	6
Pálffy	pálffy	6
Párizs	párizs	6
Pátens	pátens	6
Périer	périer	6
Rainer	rainer	6
Rajnán	rajnán	6
Robert	robert	6
Rudolf	rudolf	6
Ryukyu	ryukyu	6
Rómába	rómába	6
Sadowa	sadowa	6
Savoya	savoya	6
Sopron	sopron	6
Szajna	szajna	6
Szeged	szeged	6
Szelim	szelim	6
Szudán	szudán	6
Szíria	szíria	6
Sándor	sándor	6
Taaffe	taaffe	6
Tajvan	tajvan	6
Teleki	teleki	6
Thiers	thiers	6
Thugut	thugut	6
Vencel	vencel	6
Vendée	vendée	6
Verona	verona	6
Vilmos	vilmos	6
Vácnál	vácnál	6
Vácról	vácról	6
Wagram	wagram	6
Welden	welden	6
Wilson	wilson	6
Yorkba	yorkba	6
Zapata	zapata	6
Zsófia	zsófia	6
Északi	északi	6
MARTOS	martos	6
Ahmed	ahmed	5
Anjou	anjou	5
Annát	annát	5
Antal	antal	5
Anyai	anyai	5
Apáca	apáca	5
Apáli	apáli	5
Apály	apály	5
Artúr	artúr	5
Aztán	aztán	5
Babat	babat	5
Barát	barát	5
Basta	basta	5
Becse	becse	5
Bereg	bereg	5
Bodon	bodon	5
Borsa	borsa	5
Budán	budán	5
Budát	budát	5
Buják	buják	5
Cecey	cecey	5
Dobót	dobót	5
Donch	donch	5
Dráva	dráva	5
Dunán	dunán	5
Dunát	dunát	5
Déván	déván	5
Dévát	dévát	5
Ebben	ebben	5
Egert	egert	5
Ekkor	ekkor	5
Ennek	ennek	5
Ervin	ervin	5
Ettől	ettől	5
Ezzel	ezzel	5
Friss	friss	5
Fülek	fülek	5
Guido	guido	5
Guyon	guyon	5
Gyula	gyula	5
Gábor	gábor	5
Hadim	hadim	5
Hajdú	hajdú	5
Henok	henok	5
Hiába	hiába	5
Horea	horea	5
Hádim	hádim	5
Hősök	hősök	5
Ignác	ignác	5
Illés	illés	5
Ilona	ilona	5
Imrét	imrét	5
Innen	innen	5
Ipoly	ipoly	5
Isten	isten	5
Jajca	jajca	5
Jakab	jakab	5
János	jános	5
Jókai	jókai	5
Kankó	kankó	5
Katka	katka	5
Ketel	ketel	5
Khuen	khuen	5
Klára	klára	5
Közel	közel	5
Közép	közép	5
Lajos	lajos	5
Lajta	lajta	5
Lippa	lippa	5
Lipót	lipót	5
Lujza	lujza	5
Léván	léván	5
Malom	malom	5
Maros	maros	5
Miksa	miksa	5
Mivel	mivel	5
Mária	mária	5
Másik	másik	5
Mátra	mátra	5
Móric	móric	5
Nyári	nyári	5
Nyáry	nyáry	5
Nádor	nádor	5
Nánán	nánán	5
Nánát	nánát	5
Német	német	5
Orbán	orbán	5
Ozalj	ozalj	5
Patán	patán	5
Piust	piust	5
Porta	porta	5
Péter	péter	5
Regéc	regéc	5
Rédén	rédén	5
Rózsa	rózsa	5
Savoi	savoi	5
Seron	seron	5
Sipék	sipék	5
Sirok	sirok	5
Sirák	sirák	5
Syrak	syrak	5
Szent	szent	5
Szerb	szerb	5
Szond	szond	5
Száva	száva	5
Szőny	szőny	5
Ságot	ságot	5
Sáros	sáros	5
Sötét	sötét	5
Talán	talán	5
Tamás	tamás	5
Tarna	tarna	5
Terzy	terzy	5
Tisza	tisza	5
Tokaj	tokaj	5
Tomás	tomás	5
Török	török	5
Ugyan	ugyan	5
Vidor	vidor	5
Vácon	vácon	5
Vácot	vácot	5
Várad	várad	5
Wrbna	wrbna	5
Zichy	zichy	5
Zsibó	zsibó	5
Ácson	ácson	5
Árpád	árpád	5
Éjjel	éjjel	5
Ókapu	ókapu	5
Újvár	újvár	5
Úrnak	úrnak	5
Adams	adams	5
Adolf	adolf	5
Ahmed	ahmed	5
Albát	albát	5
Allah	allah	5
Annyi	annyi	5
Annát	annát	5
Antal	antal	5
Apafi	apafi	5
Azori	azori	5
Azovi	azovi	5
Balti	balti	5
Basta	basta	5
Bereg	bereg	5
Bihar	bihar	5
Blois	blois	5
Bodin	bodin	5
Budán	budán	5
Budát	budát	5
Colón	colón	5
Condé	condé	5
Conti	conti	5
Csele	csele	5
Cseng	cseng	5
Diane	diane	5
Drake	drake	5
Dráva	dráva	5
Dunán	dunán	5
Dunát	dunát	5
Dánia	dánia	5
Dózsa	dózsa	5
Ekkor	ekkor	5
Elbát	elbát	5
Ezzel	ezzel	5
Fehér	fehér	5
Felső	felső	5
Fülöp	fülöp	5
Globe	globe	5
Guise	guise	5
Gábor	gábor	5
Hanza	hanza	5
Hoorn	hoorn	5
Horia	horia	5
Hádim	hádim	5
Ignác	ignác	5
Ilona	ilona	5
India	india	5
Isten	isten	5
Jajca	jajca	5
Jakab	jakab	5
Japán	japán	5
Jeges	jeges	5
Jovan	jovan	5
János	jános	5
Jézus	jézus	5
Kassa	kassa	5
Kelet	kelet	5
Kjóto	kjóto	5
Kleve	kleve	5
Korea	korea	5
Kuang	kuang	5
Kubát	kubát	5
Kulpa	kulpa	5
Kínát	kínát	5
Közel	közel	5
Közép	közép	5
Kúria	kúria	5
Lajos	lajos	5
Laski	laski	5
Lippa	lippa	5
Lipót	lipót	5
Locke	locke	5
Loire	loire	5
Majna	majna	5
Maros	maros	5
Mekka	mekka	5
Miksa	miksa	5
Mivel	mivel	5
Model	model	5
Málta	málta	5
Mária	mária	5
Nepál	nepál	5
North	north	5
Nádir	nádir	5
Német	német	5
Orosz	orosz	5
Palos	palos	5
Pavia	pavia	5
Pekry	pekry	5
Pfalz	pfalz	5
Pinta	pinta	5
Porta	porta	5
Pápát	pápát	5
Párma	párma	5
Péter	péter	5
Rajna	rajna	5
Rurik	rurik	5
Rákos	rákos	5
Rómát	rómát	5
Simon	simon	5
Sully	sully	5
Svájc	svájc	5
Szung	szung	5
Száva	száva	5
Tamás	tamás	5
Temes	temes	5
Tibet	tibet	5
Tilly	tilly	5
Tisza	tisza	5
Tower	tower	5
Tudor	tudor	5
Tycho	tycho	5
Tábla	tábla	5
Urált	urált	5
Vasco	vasco	5
Vihar	vihar	5
Vinci	vinci	5
Vitéz	vitéz	5
Volga	volga	5
Várad	várad	5
Véres	véres	5
Yuste	yuste	5
Ágost	ágost	5
Állam	állam	5
Ázsia	ázsia	5
Éppen	éppen	5
Észak	észak	5
Újlak	újlak	5
TISZA	tisza	5
Alamo	alamo	5
Algír	algír	5
Allah	allah	5
Aurél	aurél	5
Berry	berry	5
Beust	beust	5
Blanc	blanc	5
Brown	brown	5
Budán	budán	5
Burma	burma	5
Bülow	bülow	5
Chile	chile	5
Civil	civil	5
Csing	csing	5
Cuzát	cuzát	5
Dezső	dezső	5
Drang	drang	5
Dánia	dánia	5
Ebben	ebben	5
Ehhez	ehhez	5
Ennek	ennek	5
Ezért	ezért	5
Fiume	fiume	5
Franz	franz	5
Fülöp	fülöp	5
Gapon	gapon	5
Garam	garam	5
Giers	giers	5
Grant	grant	5
Gyula	gyula	5
Gábor	gábor	5
Haiti	haiti	5
Hegel	hegel	5
Herzl	herzl	5
Hitel	hitel	5
Ignác	ignác	5
Ilona	ilona	5
Ilyen	ilyen	5
India	india	5
Indus	indus	5
Isten	isten	5
Jakab	jakab	5
Japán	japán	5
Josef	josef	5
János	jános	5
Jászi	jászi	5
Kassa	kassa	5
Kelet	kelet	5
Kieli	kieli	5
Kongó	kongó	5
Korea	korea	5
Korán	korán	5
Kréta	kréta	5
Kínát	kínát	5
Lajos	lajos	5
Lenin	lenin	5
Lipót	lipót	5
Locke	locke	5
Loire	loire	5
Louis	louis	5
Lázár	lázár	5
Líbia	líbia	5
Mahdi	mahdi	5
Marat	marat	5
Miksa	miksa	5
Mivel	mivel	5
Mohan	mohan	5
Morny	morny	5
Morse	morse	5
Murat	murat	5
Móric	móric	5
Natal	natal	5
Nizza	nizza	5
Német	német	5
Opera	opera	5
Orosz	orosz	5
Ozora	ozora	5
Parma	parma	5
Place	place	5
Plata	plata	5
Porta	porta	5
Prága	prága	5
Rajna	rajna	5
Rerum	rerum	5
Rómát	rómát	5
Santa	santa	5
Scott	scott	5
Sipka	sipka	5
Smith	smith	5
Sorel	sorel	5
Sucre	sucre	5
Svájc	svájc	5
Szent	szent	5
Szuez	szuez	5
Széll	széll	5
Tamás	tamás	5
Texas	texas	5
Times	times	5
Tisza	tisza	5
Tolna	tolna	5
Tomás	tomás	5
Vasba	vasba	5
Villa	villa	5
Világ	világ	5
Vácon	vácon	5
Várba	várba	5
Végül	végül	5
Vörös	vörös	5
Witte	witte	5
Zalán	zalán	5
Ázsia	ázsia	5
École	école	5
Észak	észak	5
Újabb	újabb	5
Őrült	őrült	5
SZENT	szent	5
TISZA	tisza	5
Anna	anna	4
Arad	arad	4
Arte	arte	4
Bana	bana	4
Bars	bars	4
Batu	batu	4
Buda	buda	4
Bécs	bécs	4
Béla	béla	4
Bükk	bükk	4
Csák	csák	4
Cuza	cuza	4
Dera	dera	4
Deák	deák	4
Dobó	dobó	4
Duna	duna	4
Déva	déva	4
Eger	eger	4
Egri	egri	4
Elég	elég	4
Este	este	4
Fazy	fazy	4
Fiam	fiam	4
Gara	gara	4
Gomb	gomb	4
Graf	graf	4
Győr	győr	4
Géza	géza	4
Gúta	gúta	4
Hont	hont	4
Hunt	hunt	4
Ibur	ibur	4
Ilka	ilka	4
Imre	imre	4
Ince	ince	4
Kata	kata	4
Liga	liga	4
Léka	léka	4
Léva	léva	4
Maga	maga	4
Mint	mint	4
Most	most	4
Máté	máté	4
Móré	móré	4
Nane	nane	4
Nána	nána	4
Négy	négy	4
Pált	pált	4
Pápa	pápa	4
Pécs	pécs	4
Salm	salm	4
Suhó	suhó	4
Tari	tari	4
Tata	tata	4
Több	több	4
Uram	uram	4
Vajk	vajk	4
Ádám	ádám	4
Öreg	öreg	4
Alba	alba	4
Alsó	alsó	4
Anna	anna	4
Arab	arab	4
Bach	bach	4
Bill	bill	4
Book	book	4
Brit	brit	4
Buda	buda	4
Burg	burg	4
Bécs	bécs	4
Casa	casa	4
Crni	crni	4
Csak	csak	4
Cseh	cseh	4
Diaz	diaz	4
Duna	duna	4
Eger	eger	4
Ernő	ernő	4
Etat	etat	4
Gama	gama	4
Guam	guam	4
Győr	győr	4
Háza	háza	4
Ibér	ibér	4
Imre	imre	4
Irak	irak	4
Irán	irán	4
Iván	iván	4
Jean	jean	4
Jenő	jenő	4
John	john	4
Juan	juan	4
Jüan	jüan	4
Kant	kant	4
Knox	knox	4
Káma	káma	4
Kína	kína	4
Laud	laud	4
Liga	liga	4
Makó	makó	4
Ming	ming	4
Nagy	nagy	4
Nina	nina	4
Néva	néva	4
Onaz	onaz	4
Peru	peru	4
Pest	pest	4
Pitt	pitt	4
Prut	prut	4
Pált	pált	4
Pécs	pécs	4
Roma	roma	4
Rába	rába	4
Róma	róma	4
Salm	salm	4
Sund	sund	4
Tang	tang	4
Tata	tata	4
Test	test	4
Unió	unió	4
Vasa	vasa	4
Vend	vend	4
York	york	4
Zöld	zöld	4
Ádám	ádám	4
Égei	égei	4
Írás	írás	4
MOSS	moss	4
Aden	aden	4
Alit	alit	4
Alma	alma	4
Amur	amur	4
Arab	arab	4
Arad	arad	4
Bach	bach	4
Bank	bank	4
Bika	bika	4
Brit	brit	4
Buda	buda	4
Bund	bund	4
Bécs	bécs	4
Code	code	4
Cuza	cuza	4
Deák	deák	4
Duna	duna	4
Díaz	díaz	4
Elba	elba	4
Elvi	elvi	4
Fezt	fezt	4
Föld	föld	4
Ganz	ganz	4
Gott	gott	4
Grey	grey	4
Géza	géza	4
Holt	holt	4
Horn	horn	4
Jogi	jogi	4
John	john	4
José	josé	4
Jéna	jéna	4
Jüan	jüan	4
Kars	kars	4
Káli	káli	4
Kína	kína	4
Köln	köln	4
List	list	4
Makk	makk	4
Mars	mars	4
Marx	marx	4
Metz	metz	4
Mill	mill	4
Mint	mint	4
Most	most	4
Múlt	múlt	4
Otto	otto	4
Owen	owen	4
Peel	peel	4
Peru	peru	4
Pest	pest	4
Post	post	4
Pált	pált	4
Párt	párt	4
Roon	roon	4
Ruhr	ruhr	4
Róma	róma	4
Said	said	4
Samu	samu	4
Sebő	sebő	4
Stur	stur	4
Szun	szun	4
Szűz	szűz	4
Thun	thun	4
Trek	trek	4
Unió	unió	4
Zola	zola	4
Égei	égei	4
KORA	kora	4
MOSS	moss	4
CGT	cgt	3
OHB	ohb	3
USA	usa	3