Wehrmacht	ver-mákt
Zuckerberg	cukker-berg
Actium	akcijum
Allen	e-len
Antonia	antónia
Antonius	antónijusz
Aristide Briand	arisztid brájend
Associated Press	összósiéjtid pressz
Bánffy	bánfi
Barbarossa	barba-rossza
Barth	bárt
Beaufighter	bófájtör
Beeblebrox	bíböl-broksz
BEEBLEBROX	bíbölbroksz
Bethesda	betesda
Brasta	brásztá
BRASTA	brásztá
Bristol	brisztol
Capital	kepitöl
Centauri	kentauri
CENTAURI	kentauri
Charles De Gaulle	sárl dögól
Charles de Gaulle	sárl dögól
Charta	karta
Chester	cseszter
Chicagó	csikágó
Cicero	ciceró
Civil	tcivil
Civil	szivil
Civitas	civítász
civitas	civítász
Claudius	klaudijusz
Corbett	korbet
Criminaldoctor	kriminál-doktór
DC	díszí
DC	détcé
De Gaulle	dögól
de Gaulle	dögól
Deogracias	deógrászijász
divi filius	dívi fílijusz
Divi Filius	dívi fíliusz
dominus et deus	dóminusz et deusz
Dominus et Deus	dóminusz et deusz
Ehnaton	ehna-ton
Erste	erszte
ERSTE	erszte
Erwin	ervin
Exeter	ekszeter
Fiume	fiju-me
Flagstaff	flegsztáf
Foochg	fúcsg
FOOCHG	eff-ó ó-tcéhágé
Francó	frankó
Frankenstein	frankejn-stejn
Freeman	frímen
Gallia	gal-lia
Genová	dzsenová
Google	gúgöl
Grande Armée	grán ármé
Grenoble	grenóböl
Habeas Corpus	hábeász korpusz
habeas corpus	hábe-ász korpusz
Hadrianus	hadrijánusz
Hannibal	hanibál
Hannibal	hanni-bál
Hawaii	háváji
Hawaii	háváj
Heister	hájsz-ter
Helmut Schmidt	helm-ut smitt
Heydrich	hejd-rih
Himmler	him-ler
Hjalmar Schacht	jálmár sákt
Hunter	hántör
IMF	ájemef
Instagram	insta-gramm
Jacob	dzsékob
Jeltz	jelc
Joseph	yozef
Joseph	jo-zef
Journal	zsurnál
Journal	dzsörnöl
Junius Brutus	júnijusz brútusz
Katharine	kétrin
Linde	lindi
Lindemann	linde-mann
Louis	lujíz
Louis	lují
Lucretius	lukrétciusz
Luther	lu-ter
Macbeth	mákbet
Marcus Aurelius	márkusz aurélijusz
mare nostrum	máre nosztrum
Mare Nostrum	máre nosztrum
Marine	márín
Maxwell	mekszvell
Mercedes	mercédesz
Monarchiá	monarhiá
Moran	móren
Moray	moraji
Morse	morze
Norge	norje
Octavianus	oktávijánusz
Olbers	ol-bersz
Orleans	orleán
Orleans	orlínsz
Orléans	orleán
Osnabrück	osznábrükk
Paul	pól
Paul	paul
Penzias	penzijász
Philadelphiá	filadelfijá
Plinius	plínijusz
RAF	eréjeff
Rhodes	ródz
Rights	rájtsz
Robinson	robinzon
Rouen	rüen
Royal Society	rojöl szoszájöti
Rundstedt	rund-stett
Sagan	szégen
Sang	sáng
Sang	száng
Saul	sa-ul
Simeon	sim-eon
Simeon	szimijon
Simon	shi-mon
Simon	szájmon
Smolin	szmolin
Smuts	szmútsz
Soissons	szoászónsz
Steven Weinberg	sztívön vájn-berg
Strasbourg	shtrasz-burg
Suetonius	szvetónijusz
Szuez	szu-ez
Szuezi	szu-ezi
Tacitus	tatcitusz
Talleyrand	táleran
Tennessee	tenesszi
TENNESSEE	tenesszi
Theodosius	teo-dóziusz
Theodosius	teodózijusz
Thiers	szírsz
Tiberius	tibériusz
Vercingetorix	verszan-zsétoriksz
versailles	verszáj
Versailles	verszáj
Vilnius	vil-nijusz
Virginia	virdzsínija
Wall Street	vól sztrít
Wallenstein	vállenstejn
Washington	vasington
World	vörd
Abdallah	abd-allah
Abdiel	ebdijel
Abdus Salam	ábdusz szálám
Abélard	ábelár
Abell	öbell
Abetz	ábetc
Ábrahám	ábra-hám
Abram	ébrem
Abwehr	ábver
Academy	eködemi
Acatl	ákátöl
Accel	ésszel
Access Hollywood	ökszesz hálivúd
Áchim	áhim
Acquarone	ákvárón
Acromát	ákromát
Acton	ekton
Adalbert	ádálbert
Adam Eaglin	edem íglin
Adam Mosseri	edem moszöri
Adam Riess	edem rísz
Adamick	edemik
Adams	edemsz
Addisz-Abeba	adisz abeba
Addisz-Abebában	adisz abebában
Adelhaid	ádelájd
Adenauer	áde-nauer
Adidas	adidasz
ADL	ádéel
Admiral Graf Spee	edmiröl gráf spé
Admiral Scheer	edmirÖl sér
Adolf	a-dolf
Adolf Slabynak	ad-olf szléjbinek
Adria	ad-rija
Adrian Chen	édrien csen
Aduáért	áduáért
Advance Study	ödvensz sztádi
Advanced Study	ödvenszd sztádi
Advertisernek	edvörtájzörnek
Advertising Week	edvötájzing vík
Aegates	égátesz
AEGON	e-gon
Aehrenthal	érentál
Aelia Sabináé	élija szabiné
Aelius Hadrianust	élijusz hadrijánuszt
Aelius Seianus	élijusz szejjánusz
Aemilianus	émilijánusz
Aemilius Lepidus	émilijusz lepidusz
Aeneas	éneász
Aeneás	éne-ász
Aeneis	énejisz
Aerocobrákra	áerokobrákra
Aerospatiale	erosz-péjsöl
Aetius	écijusz
Africa	afrika
Africát	afrikát
Agade	ágáde
Agamemnon	aga-mennón
Agatha Christie	ágátá kriszti
Agorán	agórán
Agorát	agórát
Agricola	agrikóla
Agrobank	agro-bank
Agustín Iturbide	agusztín iturbídé
Ahrens	árensz
Ahuja	áudzsa
AI	éj-áj
AIDS	édsz
Aigyptos	ajgüptosz
Aira	ajra
Airá	ajrá
Aircraft Interception	erkraft intörszep-sön
Aires	ájresz
Ajacciót	ázsekszijót
Akbart	ákb-árt
Akhaimenész	akháj-menész
Akhaimenida	akháj-menida
Akhaiosz	akhájjosz
Akhitófel	áktiófel
Akin	ákin
Al Capote	ál-kápóne
Aladdin	ala-din
Alamein	álámejn
Alamo	álámó
Alamos National Laboratory	álámosz nesönel lábrátori
Alan	el-len
Alan Aspect	e-len eszpekt
Alan Brooke	el-len brúk
Alan Guth	e-len gút
Alan Lightman	e-len lájtmen
Alan Turing	ellen tyúring
Alanis Moris	elenisz morisz
Alanis Morisette	elelnisz moriszet
Alarick	álárik
Albert	al-bert
Albert Bosma	álbert boszná
Albert Camus	albert kámű
Albert Einstein	albert ejn-shtejn
Albert Roden	álbert ro-den
Albert Schmid	elbört shmitt
Albert Scmid	elbört shmitt
Albi	álbi
Albin	álbin
Albrecht	álbrecht
Albrecht Haushoferrel	albreht hauszhofferrel
Alcazar	álkázár
Alcazart	álkázárt
Alcohol	alkohol
Alcubierre	álkubír
Aldebaran	áldebarán
Aldershotnál	eldersotnál
Aldo Ray	áldó réj
Aldrint	ald-rint
Alea iacta est	álejá jáktá eszt
Aleksandr Kogan	álekszándr kogán
Alekszandr Selepin	álekszándr selepin
Alerwon	álervon
Alesia	álesziá
Aletwonon	áletwonon
Aleut	áleut
Alex	áleksz
Alexandemak	alek-szandernak
Alexander	álekszánder
Alexander Friedman	álekszánder frídmen
Alexander Graham Bell	elökszendör grehem bell
Alexander Pope	álekszánder póp
Alexandre Dumas	álekszándr dümá
Alexandria	alek-szandria
Alexandrinus	alek-szandrínusz
Alexios	álekszijosz
Alexis	álek-szisz
Alfa Centauri	alfa kentauri
Alfonso	álfonzó
Alfonso Arriega	alfonzó árijega
Alfred	álf-red
Alfred Dreyfus	elfred drejfusz
Alfred Naujocks	álfred nójdzsoksz
Alfredo Stroessner	álfrédó sztrösszner
Algeciras	álheszírász
Alhazred	álházred
Alibaba	ali-baba
Alice	elisz
Alice Keezart	elisz kízárt
Alick Hale Munrónak	álik hél mun-rónak
Alighieri	áligijéri
Aliis	elisz
Alit	al-it
Alka-Seltzerei	alka szelcerei
Alka-Seltzerjét	alka szelcerjét
Alka-Seltzerrel	alka szelcerrrel
Alka-Seltzert	alka szelcert
Alkman	alk-man
Allah	allach
Allamokat	államokat
Allamokra	államokra
Allan	el-len
Allan Dullesszel	el-len dállesszel
Alleghany	aligeni
Allemagne	álemány
Allende	állende
Alles	állesz
Alley	elli
Allianz	ali-ansz
Allied Commander	ölájd kománder
Allis Chalmers Manufacturing	elisz shálmörz menöfekcsöring
Allosimanius Syneca	áloszimániusz szineka
Allosimanius Synecán	áloszimániusz szinekán
Alois Hudal	álojisz hudál
Alonzo	álonzó
Alos	álosz
Alperes	al-peres
Alphabet	álfábet
Alpha-Zero	alfa-zéró
Alpher	álfer
Alpher-Bethe-Gamow	álfer-bész-gámov
Alphonse Bertillon	álfonz bertijón
Alta Vista	al-ta viszta
Altamira	alta-míra
Alto	alto
Altruist	altruiszt
Alva	alv-a
Alva Edison	a-lva ediszon
Alvadnia	alvadnia
Alvarenga	álvárengá
Álvares	álvárez
Alvearig	álveárig
Amaltheia	amaltejja
Amar	ámár
Amazon	ama-zon
Ambrose Bierce	embróz bírsz
Ambrose Harmon	embróz hármon
Ambrosio	ambrózijó
Ambrosiót	ambrózijót
Amegliai Acélhátú	ameglijai acélhátú
Amenemhat	ámenemhát
Amenhotep	ámenhotep
America	ömerika
American	ömeriken
American Civil Alliance	ömeriken szivil ölájönsz
American Civil Liberties	ömeriken szivil libertíz
American Edge	ömeriken edzs
American Enterprise Institute	ömeriken entörprájsz insztitút
American Express	emeriken ekszpressz
American Israel Public Affairs Committeeig	ömeriken isztáel páblik öfférz komitéig
American Journal	ömeriken dzsúrnel
American Progress	ömeriken prágresz
American Psycholgical Society	ömeriken pszikolodzsiköl szoszájöti
Amerika	ame-rika
Amerikai Pszichológiai Társaság	amerikai pszihológiai társaság
Amerindian	emerindien
Amhem	árn-hem
Amin Zoufonoun	amin zöfonáun
Ammianus Marcellinus	ámijánusz márcellínusz
Amnesty International	emneszti internesönöl
Amon	ámon
Amón	ámón
Amphipolisz	amfipolisz
Amsterdam	amszterdam
Amtman	amt-mán
Amulius	amuliusz
Amundsen	amunzen
Analytica	analitika
Anastasius	ánásztáziusz
Anatolia	ana-tólia
Ancien	ánszijen
Andalsnesnél	ándálsznesznél
Anders	ándersz
Andersenhez	enderszhez
Anderson	enderszon
Anderwood Johnson	ándörvúd dzsónzon
André Maginot	andrÉ mázsínó
Andreanum	ándrejánum
Andreas Albrecht	ándreász elbrecht
Andreas Treichl	ándreász rejcsl
Andreessen	endresszen
Andrej	and-rej
Andrej Linde	ándrej lind
Andrej Szaharov	ándrej száhárov
Andreotti	ándreotti
Andrew	endrú
Andrew Barnes	endrú bárnsz
Andrew Bosworth	endrú bószvörsz
Andrew Carnegie	endrú kárnegi
Andrew Cumingham	endrú káningem
Andrew Duncan	endrú dánken
Andrew Ross Sorkin	endrú rossz szorkin
Andrewsszal	endrúzzal
Andromeda	androméda
Andronicus	andrónikusz
Andronova	andro-nova
Andropov	andro-pov
Andy Grove	endi grúv
Andy Vajna	endi vajna
Aneurin Bevan	áneurin beván
Anfa	ánfá
Angel	éndzsöl
Angeles	ándzselesz
Angelesbe	ándzseleszbe
Angers	ándzsersz
Angramainju	angramanzsú
Angwin	engvin
Anhondo	ánondó
Anjeynek	ánzsejnek
Anjie	enzsí
Anjou	anzsú
Ankara	ankarra
Anna Karenina	anna karenyina
Annába	annába
Annales	ánnálesz
Annapolis	ánápolisz
Annapolisba	ánápoliszba
Anne Shingleton	ánn singölton
Annunziata	ánnunszijátá
ANNUS	ánnusz
Anonymus	ano-nímusz
Anson	ánszon
Antaeus	ánteusz
Antaiosz	ántájjosz
Antares	ántáresz
Antarus	ántárusz
Ante	án-te
Ante Pavelic	án-te pávelics
Antelat	ántelát
Anthony Scaramucci	entoni szkárámuccsi
Anti-Defamation League	enti-deföméstön líg
Antifa	antifa
Antillák	antil-lák
Antimachiavelli	anti-mákjávelli
Antiochia	antijóka
Antiochiát	antijókiját
Antitrust	antitröszt
Anton	enton
Anton Koekemoer	enton kőkemóer
Antonescu	antoneszku
Antonin Scalia	antonin szkália
Antoninus Caracallát	antóninusz kárkállát
Antoninusok	antónijuszok
Antonio	antónió
Antonio Vargas	ántónió várgász
Antoniusé	antónijuszé
Antoniusnak Augustus	antónijusznak augusztusz
Antoniusok	antónijuszok
Antoniusszal	antónijusszal
Antti Amatus Aarne	anti ámátusz árné
Antwerpen	ant-verpen
anus mundi	ánusz mundi
Anzeli	ánzeli
Anzio	ánzijó
ANZUS	ánzusz
Aphidoknak	áfidoknak
Aphrodité	afrodité
Apollo	apolló
Appel	áppel
Appeleken	áppeleken
Appelplatzon	áppel-plátcon
Appenninek	appeninnek
Appia	appija
Appianosz	appijánosz
Appius Claudius Caecusról	appijusz klaudijusz tcekuszról
Applc	epöl
Apple	epöl
Apponyi	aponyi
April Eubank	épril őbenk
Apuleius	ápulejjusz
Apuliában	apúlijában
Aquae Sextiae	ákvé szeksztijé
Aquila	ákvilá
Aquileiát	ákvilejját
Arabfia Desert	arábia dezert
Arabia Petraea	arábija patreja
Arad	a-rad
Aran	árán
Aranda	árándá
Aranyfülcmipát	arany-fülcimpát
Arbeitskommando Krematorium	árbájtsz-kommandó krematórium
Arbeitslager	árbájtsz-láger
Arbela	árbelá
Arcadius	árkádijusz
Archibald	ár-cs-ibáld
Archibald Sinclair	ár-tschibáld szinkler
Archie Bunker	árcsi bánkör
Archives	örhájvsz
Arciszewskivel	árcsiszevszkivel
Arcturus	árkturusz
Arcturus Megagint	arktúrusz megadzsint
Ardahánra	ardahánra
Ardaser	árdászer
Ardelia	árdélija
Ardeliát	árdéliját
Ardennek	ard-ennek
Area	áreá
Arens	árensz
Arész	árész
Argabuthon	arga-buton
Argadeisz	argadejisz
Argentan	arzsantan
Argentia	arg-entína
Argentin Köztársaság	arg-entín köztársaság
Argentína	arg-entína
Argentínába	arge-ntínába
Argentínát	argen-tínát
Argentínával	arg-entínával
Arglebard Erdejének	árglebárd erdejében
Argolisz Thébai	argolisz tébaji
Argoliszból	argoliszból
Argus	árgusz
Ariete	árijet
Arieteés	árijetész
Arimateai	arim-ate-ai
Arimathiai	ari-matijai
Arirnateai	arim-ate-ai
Aristobulus	arisztobulusz
Arisztagorasz	árisztágorász
Arisztogeitón	arisztogejtón
Arium	árium
Arizona	arizóna
Arizona State University	arizóna sztéjt júnivörziti
Arizonában	arizónában
Arizonát	arizónát
Arkansas	árkánzász
Arkham	árkám
Arkhelaosz	árke-leosz
Arkintoofle Minoron	árkin-túfl min-oron
Arlington	árlington
Arlonnál	árlonnál
Armada	arm-ada
Armani	ármáni
Armenia	árménija
Armeniát	árméniját
Armia Krajowa	ármijá krájova
Armija Krajowa	ármijá krájová
Armstrong	armsztrong
Arnhem	árnhem
Arno	árnó
Arnó	árnó
Arno Dührer	arnó dűrer
Arno Penzias	árnó penzíász
Arnus	árnusz
Aronczyk	ároncsik
Arras	árrász
Arretium	árrecijum
Arrighi	ari-gi
Arromanches	áromansh
Arrow	eró
Arsakidák	árszákidák
Artaphernész	ártáfernész
Arte	árte
Arthasásztrát	ártásásztrát
Arthur Behrend	artrúd berend
Arthur Brooks	artúr brúksz
Arthur Conan Doyle	artúr konen dójl
Arthur Eddington	ártúr edington
Arthur Evans	artúr ívönsz
Arti	árti
Artner	ártner
Artrifactovol	artifaktóvol
Artur	artúr
Arty	árti
Aruba	aruba
Arzt	ártc
Aschner	áshner
Aseed	összíd
Asgard	ászgárd
Ásgard	ászgárd
Asgardról Boám Catharsee	ászgárdból boám kátárzé
Ashin Wirathu	esvin virátu
Ashley Estes Kavanaugh	eshli esztez kevenó
Ashley Kavanaugh	eshli kevenó
Ashowvia	ásóvvija
Asia	ázsija
Asikaga	ashi-kaga
Asóka	asóka
Aspen Centerben	eszpen tcenterben
Associated Pressnek	összósiéjtid pressznek
Association	összósiéjsön
Assur	asszúr
Asszad	ásszád
Astarté	ásztárté
Astor	ásztor
Astornak	asztornak
Astra	asztra
Astrának	asztrának
Astrophysics	asztofiziksz
Asztrahany	asztrahány
Atacama	atakama
Atal	átál
Atalantában	atlan-tában
Atargatisz	átárgátisz
Athanasius	átánázijusz
Athelstan	átelsztán
Athena Varounis	áténá várúnisz
Athib	átib
Athok	atok
Atlamos	atlamosz
Atlanaatban	atlanatban
Atlantic	etlentik
ATLAS	atlasz
Aton	áton
Atsra	ác-rá
Attilá	atilá
Attiláig	atilláig
Attlee	etlí
Atum	átum
Atüsz	átüsz
ATV	átévé
Auchinleck	okillek
Audacity	ódösziti
Audi	au-di
Auer	au-er
Auerstadt	au-ersh-tátt
Auger Cosmic	au-ger kozmik
Augsburg	augsz-burg
Augsburgban	augsz-burgban
Augsburgból	au-gszburgból
August Bebel	auguszt bébl
August Derleth	ogüszt derlet
Augusta	aguszta
Augusti	aguszti
Augustulust	agusztuluszt
Augustus	augusztusz
Augustuskorival	augusztusz-korival
Augustusnak	augusztusznak
Augustusnál	augusztusznál
Augustusról	augusz-tuszról
Augustusszal	augusztusszal
Augustustól Neróig	augusztusztól néróig
Augusz	augusz
Auguszteonig	auguszteónig
Augusztus	augusztus
Aulus Vitelliust	aulusz vitélijusz
Auphan	ófen
Aurangzeb	áurángzeb
aurea mediocritas	aurejá medijokritász
Aurelianus	aurélijánusz
Aurelius Antoninus	aurélijusz antonínusz
Aurelius Getát	auréliusz gétát
Aurora	au-róra
Auschwitz	ausvitc
Auschwitzhoz	ausvitchoz
Austen Chamberlain	ószten csembörléjn
Austerlitz	aushterlitz
Austin	ósztin
Australia	ausztrálija
Australopithecus	ausztrálopitekusz
Austrasia	ausztrázija
Austrasiára	ausztrázijára
Austria	auszt-rija
Austriának	ausztriának
Auto	au-tó
Avalars	áválársz
Avenida	ávenídá
Aventinus	áventínusz
Avenue	evönyú
Avenue Strategies	evönyú sztretödzsíz
Aversában	áverszában
Avignon	avinyon
Avon	a-von
Avram Iancu	ávr-ám jántzu
Avranches	evrencsiz
Axios	eksziosz
Aynesworth	éjnszvörsz
Baal	bál
Baál	bál
Baalátot	bálátot
Babat	bab-at
Babenberg	báden-berg
Babeuf	báböff
Babilon	babi-lon
Babrujszk	babrujszk
baccalaureatum	bákkáláureácum
Bach-Zelewski	bah-zelevszki
Background Explorer	bekgráund explorer
Baden	báden
Badenben	bádenben
Badeni Lajos	bádeni lajos
Badoglio	bádojjó
Badoglió	bádojjó
Baelen	bélen
Bagni	bányi
Bagratyion	bágrátijón
Bagratyon	bágrátijón
Bahama	bah-ama
Bahcall	bákól
Baidu	bajdu
Baileyék	béjli-ék
Baileyvel	béjlivel
Bakich	bákikh
Balbi	bálbi
Baldigara	báldigárá
Baldwin	bóldvin
Baleári	bále-ári
Balfour	bálfor
Balhas	bálhász
Ball	ból
Ballhausplatz	báll-hausz-plátz
Balling	bálling
Balof	bálov
Balogh	balog
Balthasar Simunich	baltazár szimunics
Balti	bal-ti
Baltimore	báltimór
BAM	bám
Bana	ba-na
Banai	banaj
BANCO STEUBEN	bánkó sztójben
Bang	beng
Banglades	bang-lad-esh
Banken	bán-ken
Banque	bánk
Banquo	bánkó
Bantam	bán-tám
Barack Obama	barak o-bama
barbaricum	bárbáríkum
Barbaross	barba-rossz
Barbarossa Hairaddin	barbarossza hájrádin
Barbarossának	barbarosszának
Barbemél	bár-bernél
Barbie	barbi
Barcelon	berszelón
Barcelona	barszelóna
Barcelonában	barszelónában
Barcelonát	barszelónát
Barclays	bárklíz
Barcsay	bar-csai
Barcza	bartca
Bardi	bárdi
Bardini Múzeum	bárbíni múzeum
Bardira	bárdirá
Bardit	bárdit
Bardwell	bárdvell
Barents	bárensz
Bargello	bárdzselló
Barham	bárhám
Bariba Macleannek	báribá mekléjnnek
Barkosiba	bárkóziba
Barnard	Bár-nárd
Barnard College	bárnörd kálidzs
Barnes	bárnsz
Barneville	bárnvill
Baron	bárón
Baron Cohen	báron ko-en
Barras	bárá
Barratt	bárát
Barrere	bárrére
Barry Bennett	berri benett
Barry Fitzgerald	berri fidzseráld
Barry Manilow	beri mániló
Bars	barsh
Bartha	barta
Bartholomeus Gothan	bártolómeusz gotán
Barthou	bártó
Bartlett	bárt-let
Bartolomeo Corsi	bártolómeó korzi
Barzoo	bárzú
Basarab	bászáráb
Basel	bázel
Baselben	bázelben
Bass	bássz
Bassée	bász-szé
Basta	básztá
Bastablon	básztáblon
Bastát	básztát
Bastille	básztíj
Bastogne	básztony
Batard-Montrachet	bátár moráse
Batchelomak	becselornak
Batchelor	becselor
BATF	béjátéeff
Báthoryak	bátorinak
Bathurstnél	bátörsztnél
Batista	bátiszta
Battle Creek	betöl krík
Batumi	bátumi
Batumitól	bátumitól
Baudouin	búdoán
Bauer	bau-er
Baumol	bau-mol
Bawdsey	bódzi
Bayerische Landesbank	bájeríshe lándeszbánk
Baylar	bájlár
Baylor	bájlor
Bayonne	bájon
Bazaine	bázen
BB	bébé
BBC	bíbíszí
Beach	bícs
Beacon	bíkön
Beard	bíörd
Beardmore	bírd-mór
Beatrice	beátrícse
Beatrice Portinari	beátrísz portinári
Beatricéje	beátrícséje
Beatrix	beátriksz
Beatty	bíti
Beaufighterekre	bófájterekre
Beauharnais	böárné
Beauvais	buove
Beckensloer	bekken-szlóer
Becket	bekett
Beda Fommnál	bérá fomnál
Beda Venerabilis	bédá veneráblilisz
Beeblebabra	bíbölbabra
Beechcraft	bícskráft
Beecher-Stowe	bécher sztóv
Beethoven	bétóven
Behrend	berend
Beigbeder	béjgbídör
Bejar	bezsör
Bekenstein	bekönsztín
Bela	bel-la
Belcredi	belkredi
Belfast	belfászt
Belfegar	belfegár
Belgioioso	beldzsojózó
Belhamedet	belhemdet
Bell	bell
Bell Laboratory	bell labratori
Bellaigue	beleg
Bellessi	belesszi
Bellosguardo	belloszguárdó
Bellosguardó	belloszguárdó
Belloy	beloj
Belon	be-lon
Belos	belósz
Belsaccar	belszákkár
Belső Kaput	belső kaput
Belvedere	bel-veder
Belvederében	belve-derében
Bemard Julia	bönrörd dzsúlia
Bender-Gestalt	bender-gestált
Benedetti	Benedetti
Benelux	beneluksz
Benes	benesh
Benioff	benijof
Benito	benító
Benito Juarez	benító huárez
Benito Juárez	Benító húárez
Benito Mussolini	benító musz-szolíni
Benjamin	bendzsámin
Benjamin Disraeli	Bendzsámin dizráeli
Benjamin Franklin	bendzsámin frenklin
Bennett	benett
Benningsen	beningszen
Benny Holcomb	beni hókomb
Bentley	bentli
Berat	berát
Berchtesgaden	berh-teszgáden
Berchtold	berh-told
Bercis	berszí
Berczely	ber-tzeli
Bereg	ber-eg
Beresford-Peirse	bereszford persz
Beretta	beret-ta
Berezina	berezíná
Berganzoli	bergándzóli
Bergenbe	berg-enbe
Bergenből	berg-enből
Bergennél	berg-ennél
Bergues	berrg
Berkeley	börkli
Berko	berkó
Berlin-Dahleini	berlin-dálemi
Berlin-Dahlem Institut	berlin-dálem insztyitút
Berlin-Dahlembe	berlin-dálembe
Berlin-Dahlemi	berlin-dálemi
Bermuda	bermu-da
Bernadotte	bernádotté
Bernard	bernár
Bernard Burke	bernárd bánk
Bernard Garynek	bernárd gerinek
Bernard Montgomery	bernár mongomerri
Bernard Shaw	bernár só
Bernard Spilbury	bárnár szpilböri
Bernardo	bernárdó
Bernardo Gabellio	bernárdó gábejjió
Bernben	bernben
Berneczki Katarina	bernetzki kátáríná
Berngard	bernárd
Bernhard	bernárd
Bernhardt	bernhárt
Bernice King	börnisz king
Bernie	börnisz king
Bernthal	bernszál
Berry	berri
Bertelsman	bertölzmen
Bertram	bertrám
Bertrand	bert-rand
Bertrand Russell	bert-ran rásszöl
Besallonon	bözálónon
Besanconba	bözanszon
Besarwonba	bözárvonba
Besitze	bezitce
Bessemer	beszömer
Bessy	besszi
Betelgeuse	betöldzsőz
Béthouart	beszoárt
Béthune	bétún
Betsaida	betszájdá
Beust	bójszt
Bevelandot	bevelándot
Bevin	bevön
Beyoncé	bijonszé
Béziers	bézijé
Bezos	bezosz
Bhagavad	bágávád
bhakti	bákti
Bháradvádzsa	bárádváddzsa
BHS BAND	bí ejcs essz bend
Bhubanesvár	bubanes-vár
Bialystok	bijalisztok
Bibliotheca Corviniana	biblijotéká korvijáná
Bickert	bikert
Biden	bájdön
Bierce	bírsz
Bierdz	bírdz
Bierut	bírút
Biester	bíszter
Bifrost	bifröszt
Big Business	big biznisz
Biggin	bigön
Bigness	bájnössz
Bihar	bih-ar
Bill	bill
Billotte	bijöt
Bimmel	bim-mel
Bing	bing
Biohub	bájoháb
Birabo	birábó
Birkenau	birk-enau
Birmingbamben	börmingemben
Birminghamben Jacobiéknak	börmingemben dzsekobijék
Birminghamből	börmingemből
Birminghamet	börmingemet
Birminghamhez	börmingemhez
Birminghamről	börmingemről
Birse	bersz
Bismarck	biszmárk
Bissau-Guineával	bisszau-gíneával
Bitola	bitolá
Bizottság	bi-zott-ság
Bjetland	bjetlend
BKV	békávé
Black Harvard Women	blekk hárvárd vimin
Black Lives	blekk lájvsz
Black Lives Matter	blekk lájvsz metör
Blackwater	blekkvótör
Blaise Pascal	blézi pászkál
Blanc	blán
Blanchard	blánsárd
Blanco	blánkó
Blanqui	blánk
Blasey Ford	bléjzi ford
Blaskovics	blash-kovics
Blaze	bléjz
Blenheim	blen-heim
Bletchley	blecsli
Blindheim	blind-heim
Blitzkrieg	blitckríg
BLM	béelem
Blockführerstube	blokkfűrersz-túb
Blockij	blotc-kíj
Bloeff	blőf
Blois	bloá
Blomberg	blúmberg
Blondie	blondi
Bloomberg	blúmberg
Bloomingsdale	blúmingsz-dél
Blücher	blücher
Blue Canoe	blú kenu
Blue Robin	blú robin
Bluesban	blúzban
Blum	blúmberg
Blumenstein	blúmen-shtejn
Bnazie	bnéjz
Boám Catharsee	boám kátárszí
Bobby	bobi
Boccaccio	bokáccsó
Bocchus	bokkusz
Bocim Catharsee	bokim kátárszí
Bock	bokk
Bocskay	bocskai
Bodajkhoz	bodájkhosz
Bodónál	bodónál
Bodor	bod-or
Boehner	bőner
Boeing	bőing
Boethius	bőtijusz
Bogazkale	bogázkále
Bogus	bógus
Bohdan Paczynski	bódán pátcinszki
Boheman	bóman
Bohle	ból
Bohlen	bólen
Böhm	bőm
Bohr	bór
Boirebista	boárebisztá
Boisson	boászón
Bokrug	bókrúg
Boldt	bolt
Boleszlav	boleszláv
Boleyn	bolejn
Bologna	bolonya
Bologná	bolonyá
Bolognában	bolonyában
Boltzmann	bol-tcman
Bombay	bombéj
Bonaparte	bonápár-te
Boncompagno	bonkompánnyó
Bondarenko	bondarenkó
Bonfini	bonfíni
Bonhomme	bonóm
Bonnet	boné
Bora Mirkovic	borá mirkovics
Borchgrevink	bórcsgreving
Bordeaux	bordó
Borgiák	bordzsák
Borgiaról	bordzsáról
Borisz Podolszki	borisz podolszki
Borja Gromov	borja gro-mov
Borkum	borkum
Bormann	bor-man
Born	born
Bornemouth	bórnmáusz
Borochovskynak	borocsovszkinak
Borzrák	borzsák
Boston	boszton
Bostonból	bosztonból
Bosworth	bószvörsz
Botticelli Primavera	boticselli primávérá
Botwood	botvúd
Bouazizi	boázizi
Boudreau	bodrő
Bougie	buzsi
Bouillon Gottfried	bu-jon gotfríd
Boulang	bölanzs
Boulder	buldön
Boulevardon	bulváron
Boulogne	bulony
Boulvard	bulváron
Bourbon	búrbon
Bournemouth	börnmáusz
Bournemouthban	börnmáuszban
Bouvines	buvin
Bowerick	boverik
Bowles	bólsz
Bowman	bómen
Boyle	bójl
Bozeman	böüzmen
Bozzal	bózzal
Bracken	brekön
Brad Parscale	bred párszkél
Brahmá	brah-má
Bram Stoker	brem sztoker
Bram Stroker	brem sztoker
Brama	bráma
Bramante	brá-mánt
Brandenberger	bránden-berger
Brandenburg	bránden-burg
Brantisvog	brentiszvog
Brastában	brásztában
Bratianut	brátyánut
Bratislava	brátiszlává
Bratisvogon	brátiszvogon
Brauchitsch	brauh-tics
Brauchitschcsal	brauh-ticcsal
Brauchitschtól	brauh-ticstól
Braun	bra-un
Brcxit	brekszit
Breda	brédá
Brendan	brendön
Brendan Bracken	brendön brekön
Brenner	bren-ner
Brentwoodban	brentvúdban
Brereton	brer-eton
Brescia	bressá
Bretagne	brötány
Brétigny	bretini
Brett Kavanaugh	bret kevenó
Breyer	brejer
Brian	brájen
Brian Zellerre	brájen zellerre
Briare	brijen
Bridges	bridzsisz
Brigetio	brigettió
Brigham	brigöm
Brighton	brájton
Brimstone	brim-sztón
Brin	brin
Britannia	brita-nnia
Britannicus	britan-nikusz
Britches	bricsiz
Britney Spearsnél	britni szpírsznél
Brno	brünó
Broadhurst	bródhurszt
Broadwayn	brodvéjn
Broadwayre	brodvéjre
Brokiánus Ultra	brokijánusz ul-tra
Broncóból	bronkóból
Bronstein	bron-stejn
Brontitall	brontitál
Brooklynban	brúklinban
Brooklynt	brúklint
Broop	brúp
Brown	bráun
Bruce	brúsz
Bruce Reed	brúsz ríd
Bruce White	brúsz vájt
Brudern	brúdern
Brugge	brűzs
Bruggébe	böröhébe
Brunanburgh	brünnen-börg
Brundisium	brundízijum
Bruneval	brün-vál
Brunevalnál	brúnválnál
Bruno	brúnó
Brunswick	brunszvikk
Brushy Mountain	brási mántön
Brutus	brútusz
Brzezinka	brzsezinka
Bubba	bub-ba
Bucher	buh-her
Buck	bákk
Buckeye	bákk-áj
Bückling	bükling
Buda-Cash	budakesh
Budd	bádd
Buddairól	báddájról
BUDDY	bádi
Budy	bádi
Buenos Aires	buenosz ájresz
Buenos Airesben	buenosz ájreszben
Buenos Airesi	buenosz ájreszi
Buff	báff
Buffallo	báffáló
Buffallo Bill	báffáló bill
Buffalo	báffáló
BUFFALO BILL	báffáló bill
Buffett	báfett
Bukarestet	bukar-estet
Bukephaleiát	bukefáliját
Bulla	bul-la
Bülow	büló
Bumm	búm
Bundesbank	bundeszbank
Bundesgesetz	bundesz-gezetc
Bundeswehr	bundesz-ver
Bunea	búnea
Bunker	bun-ker
Bunsen	bunzen
Burbank	börbenk
Bureau	büró
Burg	burrg
Burgyenko	burgyenkó
Burma	bur-ma
Burroughs	báróz
Burrus	burrusz
Burt Ovrut	bört óvröt
Busbeck	bushbekk
Bush	bush
Bushel	büshel
Business School	biznisz szkúl
Bustamonte	básztömont
Butler	bátlör
Byrd	bird
Byrnes	bernsz
Byron	bájron
Byrsnek	birsznek
Bzura	bzúra
Cabo	kábó
Cadillac	kedilek
Cádizban	kádisz
Cadogan	kádogen
Caecus	tcekusz
Caelius	tcélijusz
Caen	kájen
Caere	kájere
Caesar	tcézár
Caesarért	cézárért
Caesareum	tcézáreum
Caesariont	tcézárijont
Caesarnak	tcézárnak
Caesarok	tcézárok
Caesarra	tcézárra
Caesart Aemilius Lepidust	tcézárt émilijusz lepiduszt
Caesarum	tcézárijum
Caetani	káetáni
Caggiano	káddzsánó
Cagliari	kájjári
Cagliostro	káj-josztró
Cagney	kéjni
Caius	kájjusz
Calabi	kálábi
Calais	kálé
Calaistól Terschellingig	kálétól tersellingig
Calaveras	kálávérász
Caldwell	káldvel
California	kalifornia
Californiá	kalifornijá
California Academy	kalifornia ekedömi
Caligula	kaligula
Caligulához	kaligulához
Caligulát	kaligulát
Callgo	kólgöü
Callie	kállie
Calonne	kálonn
Calpurnia	kalpurnia
Calpurniát	kálp-urniját
Caludius	klaudijusz
Calumet	kálimet
Camarrók	kámárrók
Cambrai	kembréj
Cambridge	kémbridzs
Camegie	kárnegi
Cameron	kemeron
Camicion	kámicsón
Camillo Benso	Kámilló benszó
Camillus	kámílijusz
Camorin	kámorin
Camp David	kemp dévid
Campaign	kempéjn
Campanas	kámpánász
Campania	kámpánijá
Campaniát	kámpániját
Campbeltown	kemböltáun
Camphausent	kámphauzent
Campus	kámpusz
Campus Martius	kámpusz mártsiusz
Camus	kámű
Canada	kanada
Canahuati	kánáhuáti
CAN-AM TOURS	kenem túrsz
Candelas	kándelász
Cannae	káné
Cannes Lions	kánn lájonsz
Cannibalismo	kánibálizmó
Canning	kening
Canossa	kanossza
Canossába	kanosszába
Canterbury	kenterbörri
Canterburyi	kenterböri
Cantonban	kantonban
Cape Canaveral	kép keneveröl
Capeting	kápeting
Capistrano	kápisztránó
Capitol Hill	kepitöl hill
Capitolinus	kapitólinusz
Capitolium	kapitólium
Capote	kápóte
Capponi	káppóni
Capranicá	káprániká
Caprara	káprárá
Caprarára	káprárára
Capreae	kápreé
Caprivi	káprivi
Capua	kápua
Capuával	kápuával
Capuzzo	kápuddzó
Capuzzóba	kápuddzóba
Capuzzót	kápuddzót
Caracalla	kárkállá
Carefreeben	kerfríben
Carentan	kárentán
Cargrad	kárgrád
Cargradnak	kárgrádnak
Carl Sagan	kárl szégán
Carl Schirmer	kárl sirmer
Carleton	kárl-ton
Carleton Simon	kárlton szájmon
Carlington-Housney	kárlington háuszni
Carlinóé	kárlijóné
Carlo	kárló
Carlo Theti	kárló tetti
Carlos	kárlosz
Carlstadt	kárl-shtátt
Carlton Klubban	kárlton klubban
Carmel	kármel
Carmenek	kármenek
Carmina Buranát	kármina buránát
Carnegic	kárnegi
Carnegie	kárnegi
Carner	kárner
Carnot	kárnó
Carnuntumban	kárnuntumban
Caroberto	károbertó
Caroline Michahelles	kerölájn májköhelz
Carranza	kárándzá
Carranzának	kárándzának
Carrhae	kárráé
Carrie Wong	kerri vong
Carrol	kerol
Carroll	kerol
Carta	karta
Carter	kárter
Carterből Edmund Carter	kárterből ed-mund kárter
Cartert	kártert
Carthago	kartágó
Carvajal	kárváhál
Carvin	kárvin
Carwardine	kárvödájn
Cary Phlox	keri floksz
Casa	kászá
Casa Facebook	kászá fészbúk
Casablanca	kasza-blanka
Casablancába	kaszablankába
Casablancában	kasza-blankában
Casablancát	kaszablankát
Casca	kászká
Cascianó	kászcsánó
Caserta	kászertá
Casey	készi
cash and carry	kesh end kerri
Casimir	kázimír
Cassiodorus	kásszijodórusz
Cassiopeia	kássziópejja
Cassius	kásszijusz
Cassius-Longinus	kássziusz-longiusz
Castaldónak	kásztáldónak
Castor	kásztor
Castróék	kasztróék
casus belli	kázusz belli
Catalina	kátáliná
Catalinát	kátálinát
Catania	kátánijá
Cataniából Messinába	kátánijából messzinába
Catarac Construction	katarakt konsztráksön
Cataract Construction	katarakt konsztráksön
Cateau	sháto
Catherine	ketrin
Cathuria	kátúrija
Cathuriá	kátúrijá
Catilina	kátilíná
Catlin	kétlin
Cato	kátó
Catroux	kátró
Catullus	kátullusz
Caudillót	káudíjjó
Caumantból Vire	kómánból vír
Cavaignac	kávennyák
Cavalcanti	káválkánti
Cavalier	káválijé
Cavallero	kávájjéró
Cavour	kávör
Caxter	kárter
CBS	szíbíesz
CCD	tcétcédé
CD	tcédé
CDC	szídíszí
CDD	szídídí
Cecey	cetzei
Cecilia	szeszília
Ceczey	cetzei
Celebrated Jumping Frog	szelöbréjtid dzsámping fróg
Celebrityt	szelebritit
Celemantia	klemencia
Celephais	celefájisz
Cellmark	szellmárk
Celsius	celziusz
Ceneriai	cenerija
Center	szentör
CENTO	centó
Central	szentröl
Central Hillen	szentröl hillen
Central Parkban	szentrál parkban
Centrum	cent-rum
Centurion	tcentúrijon
Centuripét	szencsöripét
Century	szencsöri
CEO	szí-í-ó
Cerenariai	cerennárijai
Ceres	tceresz
CERN	cern
Cesare	csezáre
Cesare Borgia	csezáre bordzsa
Cesarini	cézáríni
Cesaróba	csezáróba
CEU	tceu
Ceuta	szeuta
Ceutát	tzeutát
Ceylon	szejlon
Ceylonba	szejlonba
Ceylonból	szejlonból
Ceylonig	szejlonig
Ceylonról	szejlonról
CGT	cé-gé-té
Chaerea	káerrá
Chakrabarti	shákrá-bárti
Chalesm	sálezm
Chalus	kálusz
Chamath Palihapitiya	számat palihatpitijá
Chamberlain	csembörléjn
Chamleyval	csámlival
Champagne	sámpány
Champollion	sampolijon
Champs Élysées	shanzelizé
Champs-Elysées	sanz-elizé
Champs-Élysées	shanz elizé
Chan Zuckerberg Initiative	csán tcukkerberg inisötív
Chandra	csándrá
Chandrasekhar	csándrá-shekár
Chanel	sánel
Changarnier	shenzsönyijé
Change	cséndzs
Channel	csenöl
Charante	sárant
Charge Coupled	cséndzs kápöld
Charleroit	sárlroá
Charles	csársz
Charles Christopher Cholmondeley	csársz krisztofer csámndli
Charles Forbes	csársz fórbsz
Charles Frank	csársz frenk
Charles Tilly	csársz tilli
Charlie	csárli
Charlie Hebdo	csárli hebdó
Charlotte-Amalie	shárlott ámelí
Chartában	kartában
Chartaginem	kártágínem
Chartához	kartához
Chartának	kartának
Chartát	kartát
Chartával	kartával
Charter Streeten	cseszter sztríten
Chartwellbe	csártvellbe
Çhatal	csátál
Chateubriand	shátobijan
Chatfield	csetfíld
Chaucernek	csószernek
Chautemps	csótám
Chavin	sáven
Che Guevara	csegevara
Che Guevarát	csegevarát
Cheasapeake	cseszöpík
Chen	csen
Cheney Agency	cséjni édzsönszi
Chequers	csekörsz
Chequersbe Uxbridge	csekörszbe ákszbridzs
Chequersben	csekörszben
Cher	sher
Cherwel	cservel
Cherwell	cser-vell
Chester Wilmot	csesztör vilmot
Chesterfield	csesztörfíld
Chevaliers	seválijé
Chevrolet	sevrolé
Chevron	shevron
Chevy Chase	csevi csész
Chicago	csikágó
Chicagóban Freddy Loundsot	csikágóban fredi láundszot
Chicagóból	csikágóból
Chicagói	csikágói
Chicagónak	csikágónak
Chicagóval	csikágóval
Chichén Itzá	csicsén icá
Chiffriermaschinen Aktien-Gesselschaft	sifrírmásínen ákcijen gesszelsáft
Chile	csíle
Chilé	csílé
Chilét	csílét
Chilton	csilton
Chimel	kájmöl
China Mail	csájná méjl
Chinóba	csínóba
Chinon Pacific	csájnön peszifik
Chiswickben	csizvikben
Chlodwig Hohenlohe-Schillingsfürst	kodvig hóhnlóhe shilling-fürsht
Chlór	klór
Chlorusnak	klórusznak
Chmielnicki	hmelnyicki
Cholmondeley	csálm-li
Choltitz	koltitc
Choveve Cion	shovev tzión
Chrestos	kresztosz
Chris	krisz
Chris Llewellyn Smith	krisz levlin szmisz
Christchurch	krájszt-csörcs
Christian	krisztien
Christian Glutsch	krisztijen glucs
Christianae	krisztijen
Christofle	krisztofl
Christopher	kriszto-fer
Christopher Impey	krisztofer impej
Christopher Wren	krisztofer vren
Christus	krisztösz
Chronica Ungarorum	króniká ungárórum
Chuck Schumer	csákk shúmer
Chucknak	csáknak
Church	csörcs
Churchill	csörcsil
CIA	szí-ájéj
Ciano	csánó
Cianókra	csánókra
Cianónak	csánónak
Cianóval	csánóval
CIB	tcib
Cicatrine	csikátríne
Cicerónak	tcicerónak
Cicilline	sziszilájn
Cielt	szijelt
CIG	tcé-ígé
Ciklon	tciklon
Cilian Blake	szilijen blék
Cilicia	tcilicija
Cimabue	csimábúe
Cincar-Markovic	cincár márkovics
Cincinnati	szinszinetti
Cinkotai	tcinkotai
Cinnát	tcinnát
Cinzano	cincáró
Cion	tcion
Ciprus	tziprush
Ciprust	tciprust
Circle Courtra	szörkül kórtra
Circus Maximus	tcirkusz mákszimusz
Circus Maximusban	tsirkusz mákszimusz
Cirenaica	cirenájká
Cirenaicát	csirenájkát
Cirenci Simon	tcirentci shi-mon
Ciross	szájrösz
Cisalpin	szizelpán
Cisalpina	tciszpina
Cisalpinát	tciszálpinát
Cistercium	cisztercijum
Cité	szité
Citeaux	szitó
Citerior	tciterijor
Citibank	szitibank
City	sziti
Cityben	szitiben
Cjesku	kjeszku
Claire	kler
Clairvaux	klervő
Clan Fraser	klán frezsör
Clan Lamont	klán lámónt
Clara Gougct Guzman	klárá gógt gúzmen
Clare Gorstnak	kler górsztnak
Clarence Franks	klerensz frenksz
Clarendon	klerendön
Clarice	klerisz
CLARICE STARLING	klerisz sztárling
Clark	klárk
Clark Ashton Smith	klárk eston szmisz
Clark Kerr	klárk kör
Clauberg	klau-berg
Claude	klód
Claude-Henri	klód anri
Claudia	klaudia
Claudiában	klaudijában
Claudius Nerótól	kludijusz nérótól
Claudiusoknak	klaudijuszoknak
Claudiust	kllaudijuszt
Clausewitz	klózvic
Clayton	kléjton
Clegg	kleddzs
Clemenceau	klemenszó
Clemens	klemensz
Cleopatra	kleopátra
Clerk Maxwell	klerk mekszvell
Clermont	klermon
Clevelandben	klívlendben
Clifton James	klifton dzsémsz
Clint Pearsall	klint pörszell
Clinton	klinton
Cloaca Maxima	kloáka makszima
Clomidot	klomidot
Clunyt	klúnyit
Clusium	klúzium
Clyde	klájd
Clyde Cowan	klájd kóven
CN	szíen
Cnaeus	kneusz
CNBC	szíenbíszí
CNN	szíenen
Coahoma	koáhómá
Coase	kőüz
COBE	kobé
Coca	koka
Coca-Cola	koka kóla
Coca-Colá	koka kólá
Cocceius Nerva	kotcejjusz nervá
Cocceji	kocsedzsi
Cock	kokk
Cockaday	kákdéj
Cocles	koklesz
COCOM	kokom
Codreanu	kodreánu
Coen	ko-hen
Coeur de Lion	kőr dö lijón
Cohen	ko-en
Coke	kók
Cola	kóla
Colát	kólát
Colbert	kolbört
Cole Porter	kól por-ter
Coleman	kólmen
COLFER	kolfer
Coligny	kolinyi
Colin	kolin
Colin Stretch	kolin sztrecs
College	kálidzs
Collegium Germanicum	kollégium germánikum
Collegium Hungaricum	kollégium hungárikum
Collider	kolájdör
Colliers	kolijé
Collina	kollina
Collins	kolinsz
Colmarnál	kolmárnál
Colón	kolón
Colonna	kolonna
Colonnák	kolonnák
Color	kálör
Colorado	kolorádó
Colorado Springs	kolorádó szpringsz
Coloradóból	kolorádóból
Colosseumnak	kolosszeumnak
Colosseumot	kolosszeumot
Colt	kolt
Columba	kolumba
Columbia	kolumbija
Columbia College	kolumbia kálidzs
Columbus	kolombusz
Columella	kolumella
Coma	kóma
Coma Berenices	kóma beröníszisz
Comando	komándó
Comata	komátá
Combattimento	kombattimentó
Combattimentót	kombattimentót
Combined	kámbájnd
Come Back And Say	kám bek end széj
Comines	komin
Commando	kommándó
Commcrford Martin	kámörford mártin
Commendator	kommendátór
Commendatore	kommándátóre
Commerce	komersz
Commodus	kommódusz
Common Sense	komon szensz
Commons	komonsz
Communicationsnél	komjunikéjsönsznél
Comóban	komóban
Company	kámpöni
Compiégne	kompijeny
Completely Unexpected Productions Limited	kámplítli ánikszpektid prodáksönz limitid
Compostela	komposztellá
Computer	kompjútör
Conakry	kánákri
Conasaugába	konászógába
Conaway	kánövéj
Concilium supra papam	konszílijum szuprá pápám
Concord	konkord
Concorde	konkord
Concordia	konkordija
Condé	kondé
Condillac	kondiják
Condor	kon-dor
Condorcet	kondorszet
Conducator	kondukátor
Coningham	káningem
Connecticut	kánektikát
Connétableja	konetáböl-ja
Conor	kánör
Conrad	konrád
Conradinót	konrádínót
Conseil Supérieur	konszijé szüperijör
Constantin Bratianu	konsztantin brátyánu
Constantini	konsztántíni
Constantinopolis	konsztántinopolisz
Constantinus	konsztantínusz
constantinusi	konsztantínuszi
Constantinusszal	konsztantiusszal
Constantius	konsztantijusz
Constantius Chlorus	konsztantijusz klórusz
Constatinus	konsztantinusz
Constitutio Antoniniana	konsztitócijó ántoninijáná
Constitutio Criminalis	konsztitúció kriminálisz
Constitution	konsztitúsön
Consumer Reports	kánszjúmör riportsz
Conti	konti
Contratación	kontradikszión
Convector	konvektor
Convention	konvensön
Cook	kúk
Copan	kopán
Copeland	kóplend
Copley	kópli
Corap	köráp
Corbin	kórbin
Cordeliers	kordölijé
Cordell	kordell
Cordell Hull	kordel háll
Cordoba	kordoba
Córdoba	kordoba
Córdobá	kordobá
Cordobai	kordobaji
Cordobát	kordobát
cordon sanitaire	kordon szániter
Corey	kori
Corey Lewandowski	kori levándovszki
Corkkal	korkkal
Corleone	korleóne
Cornelia	kornélija
Corneliát	kornéliját
Cornelii	kornelli
Cornelius	kornélijusz
Cornelius Jansenius	kornéliusz janzenikusz
Cornell	kornel
Cornpany	kámpöni
Coromandel	koromendel
Corporation	korporéjsön
Corpus	korpusz
Corregidoron	korridóron
Corriere	korrijere
Cortenuovó	kortenovó
Corum	káröm
Corvinus	korvinusz
Cosmology	kozmolodzsi
Cossack	kószek
Costa	koszta
Costa Scarpucciá	kosztá szkárpuccsá
Cotton	kátön
Couric	körik
Courseulles	korszöl
Courtaulds	kórdóldsz
Courtrai	kórtréj
Coutances	kutansz
Covid	kovid
Coxhoz	kokszhoz
Coxot	kokszot
Coxra	kokszra
CP	szípí
Crace	kréjsz
Craig Silverman	kréjg szilvörmen
Craigg Hogan	kréjg hógen
Cranborne	krenbörn
Cranmer	kránmer
Crassus	krásszusz
Crawford	króford
Creagh	kréj
Credit Mobilier	kredit mobilijé
Crédit Suisse	krédit szvísz
Crerar	krerár
Crescentius	kresz-centijusz
Crespy	kreszpi
CRH 	céerhá
Crimson	krimzsön
Cripple Crcek	kripöl krík
Cripps	krippsz
Crispi	kriszpi
Cristelle	krisztel
Crni	tzrni
Crocker	krákör
Croft	kroft
Croix	kroá
Cromartyig	krometi-ig
Crommelin	kromlin
Cromwell	krómvell
Crookes	krúksz
Crosstime	krosztájm
Crosswell	kroszvel
Croswell	kroszvel
Crow	kró
Crunchies	kráncsíz
Cruz	krúz
Csandragu[p]taként	csandra-guptakár
Csao Kuang	csáó kuáng
Csemegi	csem-egi
Csendes	csendes
Cserny	cserni
Csernyenko	csernyenkó
Csie	csije
Csórich	csórics
CSR	tcéeser
Csunghua Zsenmin Kunghokuo	csungua zsenmin kungokuó
Ctábor	cé tábor
Cthul	kutúl
Cthulhu	kutulu
Cujosi	kujósi
Cultes	kultesz
Cumae	kúmáe
Cumberland	kámbörlend
Cumrum Vafa	kumrum váfá
Cumrun Vafa	kumrum váfá
Cunobelin	kínibellin
Curia	kúrija
Curiája	kúriája
Curie	kürí
Curran	kárön
Curse	kőrsz
Curtis	körtisz
Curzon	kurzon
Custoz	kusztodz
Cutler	kátlör
Cuza	tzúza
Cuzco	kuszkó
Cvetkovic	tcvetkovics
Cyclon	ciklon
Cygnus	cignusz
Cypress	szípressz
Cyrus Vance	tcírusz vánsz
Czanek	cánek
Czartoryskiak	tzartoriszkiak
Czestochowában	cesztohovában
CZI	szízedáj
Czibak Imre	tzibak imre
d’Estaing	deszten
DA	dé-a
Daemones	démonesz
Daemonolatreia Remigiustól	démonolátrejja remigiusztól
Daidalosznak	dajdalosznak
Daikos	dájkosz
Daily Callert	déjli kállört
Daily Telegraph	déjli telegráf
Daimler	dájmler
Dakar	da-kar
Dakota	dak-ota
Daladier	delágyijé
Dalarhyde	dálörhájd
Dalforsas	dálfórszász
Dali	fáli
Dallas	dállász
Dallasban	dallaszban
Dalrymple Henderson	delrámpöl henderszon
Dalton	dálton
Damascius	damaszkiusz
Damaszkusz	danasz-kusz
Damian Collins	démijen kolinsz
Damjanich	damjanics
Damogran	dámórgán
Damon	démon
Damophilosz	dámo-fílosz
Dampier	dámpijé
Danforth	dánfort
Danfortht	dánfort
Dangabrad Béta	dángábár béta
Daniel	denijel
Daniel Freedman	deniel frídmen
Danielson	denijelszon
Danilo	dániló
Danmark	dánmárk
Danny Hertz	deni hertc
Dante	dán-te
Dantec	dán-te
Danzig	dántcig
Darlan	dárlán
Darmstadt	dárm-státt
Darwin	dárvin
Dasher	deshör
Dasko	dáskó
Dasseli Rajnáld	Dásszeli rájnáld
Datisz	dátisz
Datsunja	dátszun-ja
Dauphin	dofen
Dave Goldberg	dév gold-berg
Dave Willner	dév vilnör
David	dévid
David Bowie	déjvid bóvi
David Cameron	dévid kemeron
David Dreyert	dévid drejert
David Kirkpatrick	dévid körkpetrik
David Lloyd George	déjvid lojd dzsordzs
David Ricardo	déjvid rikárdó
David Vladeck	dévid vládek
Davies	déjvisz
Daviesszel	déjvisszel
Davis	déjvisz
Davos	dávosz
Davosba	dávoszba
Dawes	dóz
Dawkins	dókinsz
DB-DZ-DLS	débé dézé déeles
De imitatione Christi	de imitácijóne kriszti
Deakin	díkin
Deal	díl
Deal-Ramsgate	díl remszgéjt
Dealre	dílre
Dean Baquet	dín báket
Deannek	dínnek
Dearbornban	dírbórnban
Debate Between William Lane Craig	dibéjt bitvín vilijem léjn kréjg
Debbie Wasserman Schultz	debi vásszermán shultc
Deborah Harryé	debóra herrijé
Debre-Taborban	debre táborban
Debussy	döbüsszi
Décazes	dékáz
Decca	dekka
Decebal	detcebál
Decimus	detcimusz
Decimus Brutus	detcimusz brútusz
Decimus Junius Brutus Albinus	detcimusz júniusz brútusz álbinusz
Decius	detziusz
Dedeagapál	dedeacsnál
Deeg	díg
Deep Blue	díp blú
Défence	défensz
Defensor	defenszor
Defensor Ecclesiae	defenzor eklezsijé
defensor plebis	defenzor plebisz
Definers	difájnörz
Defoe	düfó
Dehillerin	díhilörin
Dekanoszov	dekánoszov
Dekelea	dekelejá
Delano	delánó
Delano Roosevelt	delánó rózevelt
Delaware	deláver
Delcassé	delkászé
Delhi	del-hi
Della Robbia	dellá róbijá
Delta	delta
Dembinski	dembinszki
Demerol	deme-rol
Demoiseaux	demoázó
Demokrata	demokrata
Dendre	dendrö
Denis	denisz
Denis Diderot	denisz didró
Denison Avenue	deniszön evnyú
Dennis Walsh	denisz volsh
Dentine	den-tin
Dentrassi	dentrásszi
Der Stürmer	der strűmer
Dera	de-ra
Derby Pickman Alapítvány	derbi pikmen alapítvány
Derek Franzese Zuckerberg	derek frántcéze tcukker-berg
Derleth	derlet
Déroulede	deruled
Derű	derű
Descartes	dékárt
Desdemonái	dezdemónáji
Deseretnek	dezertnek
Desert	dezört
Desiato	deszijátó
Desiató	deszijátó
Desideriust	dezidérijuszt
Desmond	dezmond
Desmond Morton	dezmond morton
Desmoulins	démulan
Dessewffy	dezsőfi
Destiny	desztöni
Detroit	ditrojit
Deus	deusz
Deus lo volt	deusz lo volt
Deutch	dójcs
Devereux	devrő
Devers	devörsz
Devon	de-von
Devonshire	devonsír
Devvar	gjú-ár
Dewar	djúár
Dhanvantari	dánvántári
Dharma	dar-ma
Dialisnak	dijálisznak
Dialogus	dijágólusz
Diana	dijána
Diane	diján
Diaz	diáz
Díaz	dijáz
Dick Durbin	dikk dörbin
Dicke	dikk
Dickens	dikensz
Dictatus Papae	diktátusz pápé
Diderot	didró
Dido	dídó
Diemnek	dímnek
Dien Bien	dijen bijen
Dieppe	gyijep
Diet Coke	dájet kók
Dieter	díter
Dieu	gyijő
Diggestnek	dáj-dzsetnek
Digital Democracy	didzsitöl demokrászi
Dijon	dizson
Dijon Drumgo	dizson drámgó
Dijonon	dizsonon
Dijontól	dizsontól
Diliny	dilöni
Dill	dill
Dimitrov	dimit-rov
Dina	dína
Dinant	dinánt
Dinasztia	dinasztija
Dinh Diem	dín dijem
Diocles	dijoklész
Diocletianus	dijokletcijánusz
Diogenész	dijogenész
Dionae	dijóne
Dionah	di-noá
Dionysius Exiguus	dijonűsziusz ekszigúsz
Diószegher Oeconomie	diószeger ökonomi
Dipayan Ghosh	dipáján gós
Diploma	dip-loma
Diploma Leopoldinum	diploma leopoldium
Dirac	dirák
Dirr Durr	dirr-dúr
Discover Magazine	diszkáver mágázín
Disney	dizni
Disney 	dizni
Disraeli	dizráeli
Disrupt	diszrápt
Ditchleyben	dicsliben
Diuban	győben
divide et impera	divíde et impérá
Divus	díviusz
divus Iulius	dívusz júliusz
Divus Julius	díviusz júliusz
Divya	divjá
DJ	dídzséj
D-nap	dénap
DNC	díenszí
DNFF	dé-en-eff-eff
DNS	déenes
Dobbs Ferry	dobbsz ferri
Documents	dákjumentsz
Dodekáneszosz	dodekáneszosz
Dodge	dódzs
Dodgson	dádzs-szon
Doemling	dőmling
Dolarhyde	dálörhájd
Dolarhyde Trevane	dálörhájd trivéjn
Dolichenus	dolikenusz
Dollfuss	dolfusz
Dolog	dolog
Dolores	dolórez
Dolores Ibarruri	dolóresz ibárruri
Domarus	domárusz
Domenique Guzmán	dom-inik guzmán
Domesday Book	dúmszdéj búk
Domingue	dománg
Dominic Crossan	dominik krosszán
Dominica	dominika
Domitianus	domitcijánusz
Domrémy	domremi
Donahue	donák-hjú
Donald	donáld
Donald Brownlee	donáld bráunlí
Donald Trump	donáld trámp
Donatello	donátelló
Donch	doncs
Donig	donnig
Donne	donn
Donnie	doni
Donon	donnon
Donovan	donoven
Don't Worry, Be Happyt	dont vörri, bí heppi
Dontól	donntól
Donyec	donyec
Doolittle	dúlitül
Doppelkopf	doppelkoff
Doppler	dopler
Dora Maar	dóra már
Dordellis	dordellisz
Dordogne	dáróny
Doria	dorijá
Dorieb	doríb
Dorman-Smith	dormen szmisz
Dornellis	dornellisz
Dornier	dornijé
Dorothy	doroti
Dorsetben	dórszetben
Dorsey	dórzi
Dottore	dottóre
Dottorét	dottórét
Douai	dúje
Douai-Péronne	duen perón
Douglas	dáglesz
Douglas Adams	dáglesz edemsz
Douglas Haig	dáglesz héjg
Douglas Richstone	dáglesz ricssztón
Douglasszal	dáglesszal
Douglastól	dáglesztól
Doumenc	dumánk
Doumergue	dümerg
Dover	dóver
Doveriszoroson	dóveri szoroson
Dovernél	dóvernél
Dovert	dóvert
Dovertől Lyme Dyig	dóvertől lím dí-ig
Dovertől Portsmouthig	dóvertől porszmáuszig
Dowd	dáud
Dowding	Downing
Downing	Downing
Doxy Ribonu-Clegg	dokszi ribonu-klegg
Dracul	drákul
Dragnet	drágnet
Dragoljub	drágoljúb
Dragoly	dragoj
Drakul	drákul
Drang nach Osten	dráng náhh ószten
Draper	drépör
Draskovichok	drashkovicsok
Draza Mihajlovic	drázá mihájlovics
Dregheol	dreg-eol
Drew	drú
Dreyfus	drejfusz
Dreyser	drejzer
Drimple	drimpöl
Drinápoly	drinápoj
Drinenbol	drinenból
Droste	drószt
Druget	drúget
Drumgo	drámgó
Drumgó	drámgó
Drusillát	druzillát
Drusus	drúszusz
Drusus Julius Caesar	drúszusz júliusz tcézár
DSM	déesem
Du Guesclin	dü geklan
Duarte	duár-te
Dubcek	dubcsek
Duberry	gyúberi
Dublinban	dáblinban
Dublint	dáblint
Dubnici	dubnici
Dubois	düboá
Dubuque Peoria	döbjűk pijórijá
Ducati	dákátti
Ducciót	duccsijót
Ducco	dákkó
Duce	dúcse
Ducében	dúcsében
Ducéhez	dúcséhez
Ducém	dúcsém
Ducénak	dúcsénak
Ducének	dúcsének
Ducét	dúcsét
Ducével	dúcsével
Duchamp	dúshemp
Duchesne	düsen
Dudley Clarke	dádli klárk
Dueze	dueze
Duff Whytock	dáff vitok
Dugard	dugár
Duke	gyúk
Dulles	dállsz
Duma	du-ma
Dumarsais	dümárszez
Dumas	dümá
Dumbarton Oaks	dámbárton óksz
Dumitru Sturdza	dumitru szturdza
Dumm	dúmm
Dumouriez	dümurijé
Duncan	dánken
Duncan Steelnek	dánken sztílnek
Dungeness	dándzsönesz
Dunkerque	dönkerk
Dunkerqueben	dönkerkben
Dunkerque-Boulogne	dönkerk bulony
Dunkerquehez	dönkerkhez
Dunkerqueig	dönkerkig
Dunwich Horror	dánv-iccs horror
Duomo	duómó
Duomó	duómó
Dupont Circle	düpón szörkül
Dupuy	düpjü
Durazzói	duráddzói
Durbin	dörbin
Durr	dúr
Dusan	dusán
Dusán	dusán
Düsseldorf	düsszeldorf
Dustin Moskovitz	dásztin moszkovitc
Dutch	dáccs
Dvke	dá-ik
Dvorak	dvorzsák
Dwight	dvájt
Dwoskin	dvórszkin
Dyer	díjer
Dylan	dilen
Dylath-Leen	dilát lén
Dynamical Theory	dájnömiköl tiöri
Dypher	dájfer
Dyson	dájszon
Dzsebel-Abiodnál	dzsebel-ábijódnál
Dzseríd	dzseríd
Dzsibuti-Addisz-Abeba	dzsibuti adisz abeba
Dzuikaku	dzuj-kaku
EAM	e-á-em
Earl Grey	őrl gréj
Eastbourne	ísztbörn
Eastern Front	ísztörn front
Eberau-Gass-Moschendorf	eberő gássz moshen-dorf
Eberhard	éber-hárt
Eberswaldéban	éberszváldéban
Ebert	ébert
EBMP	ebéempé
EBRD	ebéerdé
Eccentrica	ekszentrika
Eccentrica Gallumbitsszal	ekszentrika gallumbitsz-szal
ECHO	ekhó
Eckmannként	ekkermannként
École	éköl
Ecole Polytechnique	íkól politekník
Economic Affairs	ekonomiksz öfferz
Economic Security Project	ekonomik szekjuriti prádzsekt
ECU	e-cé-ú
Ecuadort	ekvádort
Eddie	edi
Eddington	edington
Edelpöck	edelpökk 
Edelsheim	édelsz-hejm
Edelstein	édelstejn
Edelwies	éjdelvájsz
Edennek	édennek
Edennel	édennel
Edent	édent
EDESZ	e-dá-e-esz
Edgar	edgár
Edgar Allan	edgár e-len
Edgebastonban	edzsbásztonban
Edinburgh	edinbörg
Edison	edizon
Edith Piaf	edit pijáf
Edmund Carter	endmund kárter
Edmund Halley	edmund héjli
Edmunt Henry Allenby	edmund henri elönbi
Eduardo Saverin	eduárdó száverin
Edward Bridgesnek	edvárd bridzsisznek
Edward Dean Adams	edvárd dín edemsz
Edward Snowden	edvárd sznóden
Edward Tyron	edvárd tájron
Edward Witten	edvárd vittön
Edwards	edvárdsz
Edwin Abbot	edvin ebot
Edwin Hubble	edvin háböl
Egert	e-gert
Egoist	egoiszt
Egressy	eg-resi
Egri	egri
Ehemaligen	éhemáligen
Ehenyk	ehenik
Ehrenfest	érenfeszt
Eichmann	ejh-man
Eidgenossen	ájdge-nosszen
Eidsvold	ejdszvold
Eiffel	ejfel
Eileen	ájlín
Eilona Arielnek	ejlona árijelnek
EIN	ájn
Einhard	ájnhárd
Einnahme	ejn-náme
Einsatzgrupp	ájnzácc-grupp
Einstein	ejn-stejn
Eisenach	ejzen-ákh
Eisenachon	ejzenáh-hon
Eisenho	ejzenó
Eisenhowemak	ejzenhaovernek
Eisenhower	ejzenháoör
Eisenstat	ájzen-shtát
EK	e-ká
EKG	ékágé
Elagabalus	elágábálusz
ELASZ	e-el-á-esz
Elba	el-ba
Elburz	elburtc
Elcano	elkánó
Elcanóval	elkánóval
Eldridge	eldrics
Electric	elektrik
Electrical	elektriköl
Electromagnetic	elektromegnetik
Elevation Partners	elövéjsön pártnörsz
Eliost	elioszt
Elisabeth	eliza-bet
Elisha Gray	eli-sha gréj
Elizabeth Warren	eli-zabet vóren
Ellen Pollock	ellen polák
Ellenbogent	ellenbógent
Ellicot	eliköt
Elliot Ness	elijot nessz
Elliot Schrage	eliot shrádzs
Elliott	elijot
Elmer	el-mer
ELTE	elte
Elvis	elvisz
Elvist	elviszt
Elyse Cheney	elíz cséjni
Elyseé	elizé
Emberg	imberg
Emerson Street	emerszon sztrít
EMI	íemáj
Emiliano Zapata	emílió szápátá
Emiliano Zapatát	emílió szápátát
Émilie Andéol	émil ándéól
Emily	emili
Emily Dickinson	emili dikinszon
Emmanuel	emánuel
Emmanuel Macron	emánuel mákrón
Emmeline Pankhurst	emölin pánkhörszt
Empire Boulevard	impájör bulvár
Empire Songa	impájör szonga
Empire State Building	impájör sztéjt bilding
Empress	empressz
Emsben	emszben
Encke	enki
Encyclopaedia Galactica	enciklopédia galaktika
Encyclopaedia Galacticát	enciklopédia galaktikát
Encyclopedia	enciklopédia
Endlösung	end-lőzung
Endlösung der Judefrage	endlőzung der júdenfráge
Enea Silvio Piccolomini	eneá szilvió pikkolomíni
Engels	eng-elsz
Engineer	indzsönír
England	inglend
Enigma	enig-ma
Ennius	ennijusz
Enola	e-nola
Enola Gay	eno-la géj
Enrico	enríkó
Enrico Dandolo	enríkó dándoló
Enrico Fermi	enríkó fermi
ENSZ	ensz
Enterprise	entörprájsz
Enterprise Institute	entörprájsz insztitút
Eohippus	eohi-ppusz
Eoin Colfer	eolin kólfer
EP	epé
Eperjes	eper-jes
Epheszosz	efeszosz
Epheszoszb	efeszosz
Epheszoszba	efeszoszba
Ephialtész	efijáltész
Ephilatész	efilátész
Epicuriouson	epikjúriöszön
Epidamnosz	pidámnosz
Epidauroszban	epida-uroszban
Epinalból	epinálból
Epinaltól	epináltól
EPR	epéer
Equis	ekvisz
Equities	ekvitíz
Erasmus	erászmusz
Erasmus Teuffel	erászmusz tójfel
Erat Demonstrandum	erát demonsztrándum
Erazmus	erázmusz
Erdogan	erdogán
Erebus	erebusz
Erhallung	erh-állung
Eric Londont	erik londont
Eric Schmidt	erik shmitt
Eric Simonof	erik szájmonov
Erie	íri
Eritrea	erit-rea
Erle	őrli
Ernest	ernszt
Ernest Mandel	örneszt mándel
Ernst	ern-szt
Ernst Bammel	ernszt bámmel
Ernst Busch	ernszt bush
Ernst Mach	ernszt makh
Ernst Röhm	ernszt rőm
Ernst Rutherford	ernszt rádörford
Ernstet	ernsztet
EROS	erosz
Erwin Rommel	ervin rom-mel
ESA	e-esh-a
Eschenbach	essen-bach
Escorialba	eszkoriálba
Esflovian	eszflóviján
ESMA	eshma
Esmeralda	eszmeráldá
Esmeraldá	eszmeráldá
Esmonde	ezmond
Esnunnát	esznunát
Espanola	eszpányóla
Esquilinus	eszkvilinusz
ESS	íjeszesz
Essen	esszen
Essexet	eszekszet
Establishment Summit	esztáblishment számmit
Estado	esztádó
Esterházy	eszterházi
Esteva	eszteva
Észak-Indiát Bharatavarsának	észak-indiát barata-varsának
ESZP	e-essz-pé
Etana	itáná
Étaples	étáplö
Etat	etát
Ethan Zuckerman	ítön tcukker-man
Etienne	étyijen
Étienne-Laurent	étyijen loren
Etna	et-na
Etonből	ítönből
EU	eu
Eubank	eubank
Eugene Cremmer	özsen krémer
Eugénie	özseni
Eukleidész	euklidész
Euler	ójler
Eunus	éjunusz
Euphratésznél	eufrátesznél
Eureka	euréka
Euripidész	euripidész
Europe	juróp
Eurübiadész	eurü-bijádész
Eusebius	euzé-biusz
Evans	ívönsz
Evelda	eveldá
Eveldá	eveldá
Evelyn	eve-lin
Everett	eve-ret
Evershed	evörshed
Evill	ívöll
Evita	evi-ta
Evyan	eviján
Excellenciád	ekszelencijád
Excelsior	ekszelzijór
Excentrica Bigbang	excentrika bigbeng
Exodust	ekszódusz
Experimenter	ikszperimentör
Extra	eksztra
Ezio Pinzára	edz-ijó pindzárá
Fabius	fábijusz
Fabre	fábrö
Faccbook	fészbúk
Face Book	féjsz-búk
Faceboo	fészbúk
Facebook	féjsz-búk
Facebook Menlo Park	fészbúk menló park
Factát	faktát
Factual Democracy Project	fekcsúöl demokröszi prádzsekt
Fadlan	fádlán
Fadlán	fádlán
Fairfield Osborn	ferfíld oszbórn
Falaise	fáléze
Falaise-Avranches	fález-avransh
Falange	fálánzs
Falcione	fálcsóne
Falcioné	fálcsóné
Falkenhayn	fálkenhájn
Falkenstein	fálken-shtejn
Fall	fáll
Falls Hydraulic Power	fálsz hidraulik páoör
Falmouthból	fálmáuszból
familia rustica	fámílijá rúsztiká
familia urbana	fámílijá urbáná
Familie	fámílije
Fancy Bear	fenszi béör
Faraday	feredéj
Faragho	faragó
Farmacia	fármcsijá
Farmaciá	fármcsijá
Farnese	fárnéze
Farriday	ferödéj
Faruk	fáruk
Fasci	fász-tci
Fashod	feshőd
Fatah	fátáh
Fatia Negrája	fács-csijá negrája
Fatimidák	fátámidák
Faucher	fóser
Fauchon	főson
Faucival	fószival
Faust	fauszt
Favorinói Chiara	fávorínóji csárá
Fayette	fájett
Fazy	fázi
FBI	efbíáj
FDI	efdéí
Fearnow	fírnáó
Fécamp	fékám
Federal Expresst	federöl ekszpressz-t
Federal Steel	fedöröl sztíl
Feiling	fejling
Feinstein	fájn-sztín
Feldherrnhalle	feld-hern-hálle
Felicia	felisha
Feliciana	felicsjáná
Felicianá	felicsjáná
Feliksz Dzerzsinszkij	féliksz dzsedzsinszkíj
Felix Cytrin	feliksz szitrin
Felix Díaz	féliksz diáz
Felix Kleint	féliksz klájn
Felix Schwarzenberg	félix shvártzen-berg
Felixstowe	féliksztáv
Fell	fell
Felti	felti
Fenchchurchnek	fencs-csörcsnek
Fenchurch	fencs-csörcs
Fenice	fenícse
Ferabosco	ferráboszkó
Ferdinand Hardegget	ferdinánd hárdegget
Ferdinand Lassalle	ferdinánd lázál
Ferdinand Lesseps	ferdinánd löszepsz
Fergana	fergáná
Ferguson	förgászön
Fernando	fernándó
Ferrabosco	ferráboszkó
Ferraboscó	ferráboszkó
Ferragamos	ferrágámosz
Ferrara	ferrárá
Ferris	ferisz
Festetich	festetics
Feszty	feszti
Feuerbach	fójer-bach
Feynman	fejnman
Fezt	fetz
FHB	efhábé
FHV	efhávé
FIAT	fiját
Fibonacci	fibonáccsi
Fidel Castro	fidel kásztró
FIFA	fifa
Fifth Avenue	fift evönyú
Figueiredo	fivierdó
Filippino Baby	filip-pínó bébi
Fillinger	fillin-ger
FINDER	fájndör
Fintlewoodlewix	fintölvúdölviksz
Fiona	fijóna
Firenze	fire-nze
First National Bank	förszt nesönel benk
Fischamendnél	fish-ámendnél
Fitzgerald	fidzseráld
FKGP	efkágépé
FKL	efkáel
Flaccust	flákkuszt
Flandin	flendin
Flandria	fla-ndrija
Flandriá	fla-ndrijá
Flandriában	fla-ndriában
Flandriával	fla-ndriával
Flanux	flánuksz
Flatt	flett
Flavianum	flávijánum
Flavius	fláviusz
Flea Streetben	flí sztrítben
Fleur	flőr
Fleury	flöri
Florence Nightingale	florensz nájtingél
Floyd	flojd
Fluid	flúid
Flusser	flüsz-szer
Fluvio Melia	flúvió meliá
FM	efem
fMRI	ef emeri
Foch	fosh
Focke Wulf	fokk vúlf
Focke-Wulf	fokk vulf
Focke-Wulfokat	fokk vúlfokat
Focke-Wulfot	fokk vúlfot
Fogg	fóg
Foliavintus	foliavintusz
Folkestonetól Bognorig	folksztóntól bágnörig
Fondue	fondü
Forbes	fórbsz
Ford	ford
Forensic Inquiry	forenszik inkvájöri
Foresight	fórszájt
Forest	foreszt
Formosust	foromozuszt
Forschungen	fórsúlen
Fort	fort
Fort Wayne Journal-Gazette	ford véjn dzsurnöl gázet
Fortify Rights	fortifáj rájtsz
Fortitude	fortitúd
Fortune	forcsön
Forum	fórum
Forum Boarium	fúrum boárijum
Forumtól Capitoliumig	fórumtól kapitólijumig
Foster Graham	foszter grehem
Fotitch	fotics
Fouché	fosé
Foucher	foser
Fouchéval	foshéval
Fowler	fóler
FRAGE	fráge
Fragilis	frágilisz
Framm	frámm
France	fransz
Frances	fránszesz
Francesco Crispi	fráncseszkó kriszpi
Franche-Comte	fransh komt
Franche-Comtéval	fráncsé komtéval
Franchet d’Esperey	franse deszpöre
Francis	frenszisz
Francis Bacon Crocker	frenszisz békön krákör
Francis Crickkel	frenszisz krikk
Francisco	fránsziszkó
Franciscó	fránsziszkó
Francisco Pizarro	fránsziszkó piddzáró
Francisért	frensziszért
Francisszel	frenszisszel
Francist	frensziszt
Franciszek Honiokot	fránciszek honijokot
Francli	fránkli
Franco	fránkó
Francois-Poncet	fránszoá punsze
Francóval	frankóval
Frank	frenk
Frank Adams	frenk edemsz
frank augustus	frank agusztusz
Frank Wilczek	frenk viltcek
Frankel	frenkel
Frankfurter	frank-furter
Frankiin	frenklin
Franklin	frenklin
Franklin Roosevelttel	frenklin rózevelt-tel
Frantisek Palacky	frántiszek plákki
Frantz	frántz
FRAQ	efer-ákú
Fraser	frézer
Fraz	fráz
Fred Hoyle	fred hójl
Fred Reins	fred rájnz
Frederick Douglassre	frederik dáglesszre
Frederick Hallam	frídrik hálám
Frederick Loundsnak	frederik láudsznak
Fredericka	fred-eriká
Fredrica	frederiká
Fredricá	frederiká
Freedom	freídom
Freeeeeddyyyyy	fredííí
Freeman Dyson	frímen dájszon
Freetown	frítáun
Freiherr	fráj-her
Freikorps	frájkorpsz
Frenkel	frenkel
Frére	frér
Fretensis	freten-szisz
Freud	frajd
Freya	freja
Freyberg	frej-berg
Fridrich	fríd-rik
Friedeburg	frídburg
Friedell	fridel
Frieden	fríden
Friedland	frídlend
Friedlandba	frídlándba
Friedman	frídmen
Friedmanhez	frídmenhez
Friedmann	frídmen
Friedrich	frídrih
Friedrich Nietzsche	fridrik nícse
Friendster	frendsztör
Frier	frír
Friesland	fríszlánd
Fritsch	frics
Fritz Haber	dritc háber
Fritzie Zivic	fritci tcivik
Fronde	frond
Front	frónt
Front National	front nesönel
Frootmig	frútmig
FSZFF	efeszefef
Ftábor	eff tábor
FTC	eftétcé
Fucsien	fucsijen
Fuerza Latina	fuertcá látíná
Fugger	fug-ger
Führer	fűrer
Fuka	fúka
Fulda	ful-da
Fulton	fulton
Gaál Gaszton	gál gászton
GABO	gabó
Gabo Kiadó	ga-bó kiadó
Gabriele Veneziano	gábriel venedziánó
Gadhernek	gádernek
Gafszát	gáfszát
Gagarin	gag-arin
Gaia	gájjá
Gaius	gájjusz
Galakticredit	galaktikredit
Galata	gálátá
Galatiában	galácijában
Galbraith	gáldbresz
Galenus	gálenusz
Galeotto	gále-ottó
Galerius	gálérijusz
Galilca	gali-lea
Galilea	gali-lea
Galileaifennsík	galilei fennsík
Galilee	gali-lea
Galilei	gali-lei
Galileo	galileó
Galileo Farraris	gal-ileó ferisz
Galileo Galileit	galileó gali-leit
Galina	gáliná
Galla Placidia	gállá plászidá
Galla Placidiát	gállá plászidát
Gallienus	galli-jnusz
Gallipolinál	galipolinál
Gallus	gállusz
Gama	gám
Gamalai	gama-lai
Gamble	gemböl
Gamelin	gámlen
Gammell	gámmel
Gamow	gamov
Gander	gánder
Gandhi	gandi
Ganemmel	genömmel
Garam	ga-ram
Garbo	gárbó
Garching	gárcsing
Garcia	gárszija
García	gárszija
Garda	gárda
Gari Lynn Billingsley	geri lin billingszli
Garibaldi	gari-baldi
Garrett	geret
Garrett Hobbson	geret hobszon
Garrett Jacob Hobbsot	geret dzsékob hobszot
Garri Kaszparovot	gári kaszparovot
Garrigue	gárig
Garrison	geriszon
Gary	geri
Gary Andresstől	geri ándressztől
Gary Horowitz	geri horovitc
Gary Kowalski	geri kovalszki
Gary Sanders	geri szendörsz
Gascogne	gászkony
Gasperi	gászperi
Gaston	gászton
Gaston Hallban	gászton hólban
Gasztello	gásztelló
Gates	géjtsz
Gateway	géjtvéj
Gaugamela	gaug-améla
Gaulard-Gibbs	golár gibsz
Gauleiter	gau-lájter
Gaunt	gónt
Gauss	gausz
Gavin Newsommal	gevin nyúszommal
Gavrilovic	gávrilovics
Gawker	góker
GCC	dzsí-szíszí
Gchat	dzsí-cset
Gcoghegan	gőgegán
Gdansk	gdaanszk
Gdanskért	gdan-szkért
GDP	dzsídípí
GE	dzsí-í
GEC-EBRD	gé-e-tcé-ebéerdé
Geco	gekó
Gedlurnbits	gedlörnbitsz
Geehan	dzsíhen
Geiger	gejer
Geilenkirchen	gejlenkirsen
Geimber	gejmber
Geiserich	gejserih
Geissler	gájszler
Gemina	gemina
Gene Roddenberry	dzsín rodden-berri
Gene Trimble	dzsín trimöl
General Archives	dzseneröl arhájvsz
General Briare	zseneral brijer
General Electric	dzseneröl elektrik
General Statennel	dzsenerál sztetönnel
General Weygand	zseneral véjgran
Générale	zsénérál
Generalgouvernement	zsenerál-güvernmen
Genes	dzsínz
Genetrix	dzsenetriksz
Genfben	genf-ben
Genius	géniusz
Gennargentu	dzsenárdzsentu
Gennath	dzsenász
Genova	dzsenova
Genován	dzsenován
Genovával	dzsenovával
Genscher	gen-ser
Gensoul	zsoszul
Gentilhomme	zsantijöm
Gentilis	dzsentilisz
Geoffrey	dzsof-ri
Geoffrey Burbidge	dzsofri bördbridzs
Geoffrey Chaucer	dzsofri csószer
Geoffrey Potocki	dzsofri pátoki
Geoffry Sachs	dzsoffri szeksz
Geoghegan	gőgegán
Geographiája	geográfiája
Georg Paradeiser	ge-org párá-dízer
Georg Thorfinnssenre	georg torrfinszenre
George	dzsordzs
George 	dzsordzs
George Clerk	dzsordzs klerk
George Monk	dzsordzs monk
George Washingtont	dzsordzs vasingtont
Georges	zsorzs
Georges Clemenceau	zsorzs klemenszó
Georges Danton	dzsorzs dánton
Georges Duby	dzsordzs dubi
Georges-Louis Buffon	zsorzs-lují bufon
Georgetown	dzsordzs-táun
Georgi Dimitrov	gregorí dimitrov
Georgia	dzsordzsa
Georgiai	dzsordzsai
Georgica	geor-gika
Georgicont	geor-gikont
Georgij Lvov	gregoríj lövóv
Georgiu Baritiu	dzsórdzsu báritu
Gerald Ford	dzserárd ford
Gerascsenko	gerascsenkó
Gerbert	gerb-ert
Gerd	gerd
Gergely	ger-gej
Gerhard	ger-hárd
Gerhardt Bohne	zserár bón
Gerizim	dzserizim
Germain	zsörmen
Germania	germánija
Germanicus	germánikusz
Geronimónak	dzseronímónak
Gesellschaft	gezell-sáft
Gesta Hungarorumban	gesta hunga-rórumban
Gestap	gestáp
Gestapo	gest-apó
Gestaponál	gestápónál
Gete	zset
Gettysburgbc	getisz-börgbe
Gewerkschaft Securitas	geverksáft szekuritász
Ghaznavidák	gáznávidák
Gheorghiu	görgjú
Ghettim	gettim
ghibellin	gibellin
Ghiberti	giberti
Ghiraj	giráj
Ghonim	gónim
Ghyczy	gitzi
Giacomo Durando	dzsákomó durándó
Gianbattista Castaldo	dzsijánbáptisztá kásztáldó
Gibson-Hawking	gibzon-hóking
Gideon Hausner	gidion hauszner
Gien	dzsen
Giers	gírsz
Gigantomakhiát	gigantomakiját
Gil Robles 	zsill roble
Gilbert	zsilbert
Gilbert Stuart Washington	gilbört sztúárt vasington
Gilded	dzsildöd
Giles Dumain	zsill düm-en
Gilian Blake	dzsilien blék
Gillespie	dzsilszpáj
Gillis	zsillz
Gimes	gi-mes
Gingko Biloba	ginkó bilóba
GINI	dzsini
Ginzburg	ginz-burg
Gioberti	dzsoberti
Giolitti	dzsolitti
Giorgio	dzsordzsó
Giorgio Vasari	dzsordzsó vászári
Giotto	dzsottó
Giottó	dzsottó
Giovanni	dzsovánni
Giovanni Doria	dzsovánni dorija
Giovanni Giolitti	dzsovánni dzsolitti
Giovanni Medici	dzsovánni medicsi
Girardeau	zsirár-dő
Giraud	zsiró
Girls	görlz
Girolamo	dzsirolámó
Girolamo Savonarola	dzsirolámó szavonaróla
Gironde	zsirond
Giscard	zsiszkár
Gisin	dzsizin
Giskra	gishkra
Giudici	dzsúdicsi
Giuliano	dzsulijámó
Giulianó	dzsulijámó
Giuliano Rovere	dzsuliánó róvere
Giulio Turcho	dzsúlió turcsó
Giuseppe Mazzini	dzsuzeppe máddzíni
Givenchy	dzsivencsi
Givet	zsivé
Givet-Namur	zsivé námúr
Gizmodo	dzsizmodó
GKI	géká-í
Gladiator	gladijátor
Gladstone	glád-sztón
Glaser	glászer
Glashow	gláshó
Glastonbury	glásztonbörri
Gleiwitz	glájvic
Glenn Beck	glenn bekk
Glenn Stackmann	glen sztekmen
Glinszkij	glínszkíj
Global Positioning System	globöl pozisöning szisztem
Globe	glób
Gloria Steinem	gloória sztrájnem
Gloucester	glokeszter
Gmail	dzsíméjl
Gneisenau	gnejszenau
Gnorrik	gnorrik
Gnyezdovo	gnyez-dovó
Goat Island	gót ájlönd
Göbbels	göbb-elsz
Goddard Institute	gúdörd insztitút
Godesbergbe	gődesz-bergbe
Godfroy	godfroj
Godwin-Austen	godvin ósztin
Goebbels	göbbelsz
Goenka	goenka
Golby	golbi
Goldberg	gold-berg
Golgafrincham	golga-frincsem
Goluchowski	glushovszki
Gonder	gonder
Good Will Hunting	gúd vill hánting
Goodman	gúdmen
GOODYEAR DOUBLE EAGLE	gúdyőr dáböl ígöl
Googleplex Gondolkodó Csillaga	gúgölpleksz gondolkodó csillaga
Goonhilly	gúnhilli
Gordon	gor-don
Gordon Kane	gordon kéjn
Gore	gór
Görgey	görgei
Göring	gőring
Gort	gort
Gospels	gosz-pelz
Gospic	goszpik
Gossage	gászidzs
Gothában	gotában
Gott	gott
Gottfried Leibniz	gotfríd lejbnizc
Gould	gúld
Goules	gúlz
Gove	góv
GPS	dzsípíesz
Graaf	gráf
Grabski	grabszki
Gracchus	gráhhusz
Gracie	grészi
Graf Spee	gráf spé
Grafton	gráfton
Graham	grehem
Grahme	gráme
Gramsci	grámszki
Granada	gran-ada
Grand Armada	gránd ármádá
Grand Sasson	gran szászón
Grand Street	gránd sztrít
Grand Unified	grand júnifájd
Grandétól	grándétól
grandeur	grándőr
Grandi	grándi
Grand-Quartier	grán kvártyijé
Grant	grent
Gratus	grátusz
Gravelines	grávlin
Gravesend	gréjvszend
Gravitációs	gra-vitációs
Gray	gréj
Graz	grátc
Graziamtól	grácijámtól
Grazién	grácijén
Great	gréjt
Great Barrington	grét berington
Green	grín
Green Lane	grín léjn
Greenblatt	greínblátt
Greenspan	grínszpen
Greer	grír
Greg Bear	greg béör
Greg Laughlin	greg láflin
Greg Mauert	greg mau-ert
Gregor Strasser	gregor strásszer
Gregoriana	gregoriáná
Greta Garbo	gréta gárbó
Gretchen Townban	grecsen táunban
Grimm	grim
Gritti	grit-ti
Groener	grőner
Gromiko	gromikó
Grönland	grön-land
Gross	grossz
Gross Rosen	grossz rózen
Group	grúp
GRU	géerú
Grumann Gulfstream	grú-man gálfsztrím
Grumman	grú-men
Guadalajaránál	gvádáláháránál
Guadalcanal	gvádálkánál
Guam	guám
Guamot	guámot
Guanahani	guánáháni
Guardian	gárdijen
Guardiannek	gárdiennek
Guatemala	gvate-mala
Guatemalába	gvátemálába
Guayaquilben	gvájákilben
Gubbins	gábensz
Gucci	guccsi
Guccifer	dzsúsziför
Guderian	gúderiján
guelf	gvelf
Guernicának	gernikának
Guernsey	gernzi
Guevara	guev-ara
Guide	gvájd
Guido	gujdó
Guido Schmidtet	gujdó smittet
Guido Schmidttel	gujdó smittel
Guinea	gínea
Guinness	gínisz
Guiscard	zsiszkár
Guise	gíz
GULAG	gulág
Gulagok	gulágok
Gulfstream	gálf-strím
Gumb	gámb
Günzburgban	günc-burgban
Gupta	gupta
Gurdjieff	gurdzsiev
Gurion	gurijon
Gustav	gusztáv
Gustav Bimmel	gusztáv bim-mel
Gustav Genschov	gusztáv gensov
Gustav Vasa	güsztáv vasza
Gustloff	gusz-loff
GUT	gút
Guten Abend Jungs! Ihr werdet bald alle krepieren, nachher aber kommen wir.	gúten ábend jungsz! Ír ver-det báld álle krepíren, náh-her áber kommen vír.
Guth	gút
Guthi	gúti
Guyanába	gvájánába
Guyon	guj-on
GWU	gé duplavé ú
Gwyneth Paltrow	gvinet pátró
Gyermekei	gyermekei
Gyönyörű Sarnath	gyönyörű szárnát
Haas	hász
Habeas	hábe-ász
Haber	háber
Habermast	hábermászt
Habichtsburgról	hábihtsz-burgtól
Habrey	hébri
Habsburg	habsz-burg
Hack Team	hekk tím
Hacker	hek-ker
Hadikomputer	hadikompjúter
Hadrianopolis	hadrijánopolisz
Hadron	hadron
Hadrumetum	hadrometum
Hadzsi Murat	hádzsi murát
Hafner	hefner
Hafré	háf-ré
Hagelin	hégelájn
Hagelmayer	hágel-májer
Hagen	hágen
Hagia Sophia	ájá szófija
Hagia Sophiát	aja-szófiját
Hahnemüle	háne-mülle
Haida	hájdá
Haig	héjg
Haireddin	heredin
Hake	hék
Half Moon Bayben	hálf mún béjben
Half Moon Investigations	hálf mún invesztigéjsönz
Halfruntot	hálfruntot
Hali	heli
Halifax	helifeksz
Halifaxszel	helifekszel
Hall	hól
Hallam	hálám
Halley	héjli
Hamburg	ham-burg
Hamilton	hemilton
Hamlet	hamlett
Hammacher Schlemmer	hámáhher slemmer
Hammois Totalleé	hemoá totálé
Hammurapi	hamurappi
Hammurápi	hamu-rappi
Hampden	hempdön
Hampshire	hemp-sír
Hanford	henford
Hanfstaengl	henfsztengl
Hangö	hángő
Hangu	hángu
Hanks	henksz
Hannah	háná
Hannibál	hanibál
Hannibal ante portas	hanibál ánt-e portász
Hannibal Lecter	hanibál leh-ter
Hannibaléhoz	hanibáléhoz
Hannover	hanóver
Hanoi	hanoji
Hans	hánsz
Hans Bethe	hánsz bít
Hans Moravec	hánsz moravetc
Hansemannt	hánsze-mánnt
Hanwha	hanva
Harbath	hárbász
Harbor	hárbor
Harbour	hárbör
Harcias Frigyes	harcijas frigyes
Hardand	hárdánd
Hardy	hárdi
Hare	hár
Harfleur	áflőr
Hargreaves	hárgrívsz
Harl	hárl
Harléról	hárléról
Harley Warren	hárli vóren
Harley-Davidson	hárli déjvid-szon
Harlow Shapley	hárló shepli
Harmenze	hármentce
Harmon	hármon
Harold	herold
Harper	hárpör
Harriman	herimen
Harris	herisz
Harrison	heriszon
Harrodsé	herodszé
Harry	herri
Harry Hopkins	herri hopkinsz
Harry Hopkinsszal	herri hopkinsszal
Harry Hopkinstól	herri hopkinsztól
Harry Houdininak	herri húdininek
Hart	hárt
Hartland Snyder	hártlánd sznájder
Hartle	hártöl
Harvard	hárvárd
Harvardon	hárvárdon
Harvey	hárvi
Harwichból	hárvikból
Harwichtól Portsmouthig	hárviktól portszmáuszig
Harwood	hárvúd
Harz	hártc
Hasdrubal	hásdrubál
Haselden	hászelden
Hasmoneus	hászmóneusz
Hasselt	hásszelt
Hastings	hésztingsz
Hastingsnél	hésztingsznél
Hastur	has-túr
Hatch	hets
Hate	héjt
Hatheg	háteg
Hathegei	hátegej
Hatheg-Kla	hátheg klá
Hathor	hátor
Hatteras	hátterász
Hattusasban	hattuszaszban
Hauptkriegsverbrecher	haupt-kríg-ferbréh-her
Hauptsturmführer	hauptsturm-fűrer
Haushofernek	hausz-hoffernek
Haushofert	hausz-hoffert
Hausmann	hausz-mann
Haverhillben	háverhillben
Havre	ávrö
Hawaiin	hávájin
Hawaiinál	hávájnál
Hawaiitól	hávájtól
Hawailuson	hávájluszon
Hawalius	hávájlusz
Hawking	hóking
Hayek	háj-ek
Haynau	haj-nau
Háziújságjának	házi-újság
HBCU	hábétcéú
HD	hádé
Headet	hedet
Heathrow	híszró
Heaviside	heviszájd
Hebridákon	hebri-dákon
Heckenast	hkknászt
Heer	hér
Heeres	hersz
Hegel	hégel
Heidenheimban	hájden-hájmban
Heidenstam	hájdensztem
Heien	Helen
Heim	heim
Heimlich	hájmlih
Heimwehr	hejm-ver
Heine	hájne
Heinlein	hájnlájn
Heinrich Gustav Magnus	hejnrik gusztáv mágnusz
Heinrich Hertz	hejnrik hertc
Heinrich Himmler	hejnrih him-ler
Heinrich Schliemann	hejnrich slíman
Heinz Pagels	hejntc pédzselz
Heisenberg	hejzenberg
Heisenberg-Pauli	hejzenberg-pa-uli
Heisler	hájz-ler
Heléna	helé-na
Helenét	helenét
Helfy	helfi
Helgoland	helgolánd
Helgolandi	helgo-lándi
Heliogabalus	hélijógábálusz
Heliosz	hélijosz
Hellasz	hel-lász
Heller	hel-ler
Helleu	heleü
Helmholtz	helmholtc
Helmut Kohl	helm-ut kól
Héloise	élojíz
Helsinki	helszinki
Helvét	helvét
Helvetius	helvéciusz
Helvius Pertinaxot	helvijusz pertinákszot
Hemphill	hemfill
Hempton	hempton
Hendaye	hendéj
Henderson	henderszon
Hengel Crucifixion	hengel krutci-fikszión
Henlein	henlájn
Henlein-Benes	henlájn benesh
Henninger	henin-ger
Henriette Heavitt	henriet hivit
Henry	henri
Henry Bolingbroke	henri bolinbrokk
Henry Moray	henri moréj
Henry Morton Stanleyt	henri morton sztenlit
Henry Tizard	henri tizár
Henry Tudor	henri tyúdor
Hentzi	hentzi
Héphaisztosz	héfájisztosz
Hérakleopolisz	héreklejopolisz
Héraklész	héráklész
Herald	heröld
Herbert	her-bert
Herbert Curtis	herbert körtisz
Herbert Marcuse	her-bert márkjúz
Herbert Morrison	her-bert moriszon
Herbert Spencer	herbert szpenszer
Herbeville	herbevill
Hercegség	her-cegség
Hercules	herkules
Herculis	hörkjulíz
Herculius	herkúlijusz
Herder	her-der
Hereward Carrington	herövórd kerington
Hermann	her-man
Hermann-Göring-Werke	her-man gőring verke
Hermes	hörmíz
Hernán Cortés	hermán kortesz
Herod	Heród
Hérophilosz	hérofílosz
Herriot	heri-jot
Hertz	hertc
Herzen	hertzen
Hess	hessz
Hewitt	hjúit
Heydebreckben	hejdebrekk-ben
Hierapolisz	hijera-polisz
Hieronymus Laskit	hijerónimusz lászkit
Higgins	higinsz
Higgs	higsz
High	háj
Highland	hájlend
Hihersnek	híhersznek
Hilary	hilöri
Hildebrand	hilde-bránd
Hilferding	hilferdig
Hilhnamiek	hilnámijek
Hill	hill
Hillary	hilöri
Hillgarth	hilgárt
Hillman	hilman
Himilko	himilkó
Himler	him-ler
Himmlemél	himm-lernél
Himmlerstadt	him-lerstátt
Hindenburg	hinden-burg
Hiper Menta Extraktumotegy	hiper menta eksztraktumot
Hipper	hip-per
Hippiasz	hippijász
Hirammal	hirámmal
Hirohito	híro-hitó
Hirschman	hirsh-men
Hispania	hiszpánija
Hispánia	hiszpánija
Hispaniába	hiszpánijába
Hispániába	hiszpánijába
Hispaniából	hiszpánijából
Hispaniáig	hiszpánijáig
Hispániáig	hiszpánijáig
Hispánián	hiszpániján
Hispaniát	hiszpániját
Hispaniától	hiszpánijától
Hispaniola	hiszpánióla
Historiaet	hisztórijáet
Historical	hisztoriköl
Historical Jesus	hisztoriköl dzsízösz
History	hisztori
Hitchikers Guide	hicshájkörsz gájd
Hitler	hit-ler
HIV	hív
HJVSA	hájé-vé-essa
Hlanith	hlánit
HMS	éjcsemesz
Hoare	hoáre
Hobart	hóbárt
Hobbs	hobsz
Hoboker	háböker
Hochbichler	hóh-bihler
Höchstadt	hőh-státt
Höchstadtnál	hőshtáttnál
Hodges	hádzsisz
Hoefflinger	hőflinger
Hoek	hők
Hoepner	hőpner
Hofmann	hoff-man
Hohenstaufen	hóen-staufen
Hohenzollern	hóhen-collern
Holbach	hol-bach
Holcomb	hólkomb
Holger Nielsen	holger nílzen
Hollingsworth	hálingszvörsz
Hollis	holisz
Hollywood	hálivúdd
Holmdell Horn	holmdel horn
Holocaust	holo-kauszt
Holy Lochnál	holi lokknál
Home	hóm
homo faber	hómo fáber
Homonnai Drugeth	homon-nai drúget
Hondo	hondó
Honduras	hondurász
Honecker	honekker
Honiok	honnyok
Honnecourt	hánkőrt
Honolulu	hono-lulu
Honorius	honorijusz
Hookban	húkban
Hooloovoo	húluvú
Hoorn	hórn
Hopkins	hopkinsz
Horace	horász
Horatius	hotáciusz
Horava	horává
Hore-Belisha	hóre belisá
Horkheimer	horkhájmer
Horowitz	horovitc
Horramsahr	horrámszár
Horrisoni	Horriszon
Hortensia	hortenzija
Hortensius	hortenzijusz
Hosius	hósziusz
Höss	hössz
Hostilius	hosztíliusz
Hoszni Mubarak	hoszni mub-arak
Houffalize	úfálíze
Hounslow	háunszló
House	háusz
Houston	hjú-szton
Houstonban	hjúsztonban
Howard	hao-várd
Howard Carter	hao-várd kárter
Howard Connor	ha-oárd  ko-nor
Howard Vogttal	haovárd vógt-tal
Howhi	háuvi
Hoyle	hójl
HR	há-er
Hradzsinba	hra-dzsinba
Hrebenar	hrébe-nár
Hrung	hráng
Hszi Csin	hszi csin
Hszia	hszíja
Hsziafenyő	hszíjafenyő
Hszihszia	hszíszija
Huantar	huántár
Huascar	huászkár
Huawei	hua-vej
Huayna Capac	huájná kápák
Hubatsch	hubács
Hubble	háböl
Hubka	hábka
Hubkához	hábkához
Hudal	űdál
Hudson	hádzön
Huelva	huel-va
Huerta	uertá
Huertának	uertának
Hugh	hjú
Hugh Everett	hjú everet
Hugh Ross	hjú rossz
Hughes	hjúz
Hugo Stinne	hugó sztájnsz
Huitzilopochtli	hujicilopoktli
Hulah	huláh
Hulk Hogannek	hálk hogennek
Hull	háll
Human Rights	hjúmön rájtc
Humber	hámbör
Humbert	ámber
Hungaria	hungárija
Hungariá	hungárijá
Hungaricum	hungárikum
Hungary	hángöri
Hunian	hánijen
Hurkon	hárkön
Hurrem	hur-rem
Hurricane	hárökéjn
Hurricaneés Spitfire	hárökéjn és szpitfájer
Huston Street	hásztön sztrít
Husz	husz
Húszéin	husszejin
Hutchinson	hácsinzon
Huxley	hákszli
Huyig	hújig
Hüyük	hüjük
HVB	hávébé
HVG	hávégé
Hydrogen	hidrogén
Hyen	hijen
Hyman Minsky	hájmen minszki
Hythe	hít
I Will Survive	áj vill szörvájv
I. G. Farben 	ígé fárben
Iába	lába
Iábszárát	 lábszárát
Ianiculus	jánikulusz
Ianus	jánusz
Iátok	látok
Ibenskas	ájbenszkász
IBM	ájbíem
Ibrahim	ibrahim
ICARUS	ikarusz
ICBM	í-tcé-béjem
Idái Sherernek	ájdá serernek
Iejaszu	iejaszu
Ieper	íper
Ieper-Comines	íper kómin
Ietűnt	letűnt
IFRS	í-ef-er-es
Igazsagh	igazság
Iger	ájgör
Ignacio Molina Pérez	ignászió molina perez
Ignaz Lederer	ignátz léderer
il Magnifico	il mányifíkó
Ilcsenko	ilcsenkó
Île-de-France	ill dö fransz
Ilek-Vadban	ilek vadban
Iliász	ílijász
Illan	il-lan
Illinois	ilinoj
Illustrious	illusztrösz
Illyés	íjés
Illyricum	illírikum
Imannuel Kant	imánuel kánt
Imiisfree	imiszfrí
Immanuel Kant	imánuel kánt
Immanuel Wallersteint	imánuel váller-shtejn
Imperator Caesar Augustus	imperátor tcézár augusztusz
Imperator Caesar Vespasianus Augustus	imperátor tcézár veszpázijánusz augusztusz
imperium Christianum	impérijum krisztijánum
Imphalnál	imfálnál
Imporcitor	importszítor
Ince	intze
Incognitusnak	inkognítusznak
Indosuez	indo-szuez
INDOTEK	indotek
Indra	índra
Indus	indush
Inelle	inelle
Inferior	inferijór
Inferno	infernó
Information	informéjsön
Infowars	infovórsz
Inglefield	ingölfíld
Ingram	ingrem
Inka	in-ka
Inna	inná
Innamorati	inná-moráti
Innben	inn-ben
Innisfree	iniszfrí
Innitzer	ínicer
Innsbruckba	insz-brukba
Innsmouth	inszmáusz
Inoue Niszso	inouve nissó
Inquanok	inkvánok
Insitor	inszitor
Inskip	inszkip
Insta	inshta
Institute	insztitút
Institutio	insztitúció
Institution	insztitúsön
Intel	intel
Intelligence Service	intelidzsönsz szörvisz
Intelligence Servicere	intelidzsönsz szőrvisz
Interacting Massive	intörekting mesziv
Interactive Massive Particles	interaktív messzív pártikölz
Internet	internet
Internet Observatory	internet obszörvatori
Interpol	inter-pol
Interpretation	interprötéjsön
Inukai	inukáj
Invention	invensön
Investigation	invesztigéjsön
Ioan	ioán
Iogyan	Hogyan
Iónia	jónija
Ióniában	jónijában
Ióniára	jónijára
Iovis	jóvisz
Iovius	jóviusz
Iowa	ájova
Iowában	ájovában
IP	ájpí
Iphigeneiát	ifigéniját
Ipoh	ipok
Ippocampó	ipokampó
Ippolito	ippolitó
Ipswichtől Cornwallig	ipsz-viktől kornvólig
IRA	ira
Irak	irak
Iranon	iránon
Ired	ired
Irem	irem
Irémnek	irémnek
Irit	ájrit
IROC	ájerószí
IRS	ájeresz
IRT	ájertí
Isaac	ájszek
Isaac Asimov	ájszek aszimov
Isaac Newton	ájszek nyúton
Isabel Mendia	izabel mendíjá
Ishngtonban	isingtonban
Isigny	isziny
ISIS	ájszisz
Island	ájlend
Islington	ájlington
Isszosz	josszosz
IT	ájtí
Italia	itálija
Italica	itálika
Ithaka	itaka
Ithakába	itakába
Iudaeaban	júdeában
Iudea	júdea
Iudeae Pontius Pilatus	júdeá pontcijusz pilátusz
Iugurthát	jugurtát
Iulia	júlija
Iuliát	júliját
Iulius Caesar	júlijusz tcézár
Iulius Caesar Octavianus	júlijusz tccézár oktávijánusz
Iulius-Claudius	júlijusz klaudijusz
Iuliusok	júlijuszok
Iulusra	júluszra
Iunius Brutus	júnijusz brútusz
Iuno	júnó
Iunóé Héráéval	júnóé héráéval
Iunónak	júnónak
Iunót	júnót
Iustinianus	jusztínijánusz
Iuvenalis	júvnálisz
Ivan	iván
Ivan Karamazov	iván karam-azov
Ivanovics	ivánovics
Ivry	ájvöri
Izeyl	ájzejl
Jabbo	dzseb-bó
Jacinda Ardern	jászinda árdern
Jack	dzsek
Jack Johnson	dzsek dzsónzon
Jack Masey	dzsek mézi
Jackson	dzsekszon
Jacksonville	dzsekszonvill
Jacob Bekenstein	dzsékob békönsztín
Jacob Hobbsot	dzséjkob hobszot
Jacob Schoellkopf	dzsékob shöllkoff
Jacobi	dzsekobi
Jacóbiék	dzsekobiék
Jacobs	dzsekobsz
Jacoby	dzsekobi
Jacopo	dzsákopó
Jacopón	jákopón
Jacquerie	zsákrí
Jacques Hadamard	zsák hedmárd
Jacques Loeb	dzsák lőb
Jacqui Graham	zsákí grehem
Jagadish Chandra Bose	dzságádish csándrá bóz
Jagoda	jag-oda
Jaguar	jaguár
Jaguarral	jaguárral
Jahve	jah-ve
Jahvéhoz	jah-véhoz
Jahvekultusza	jah-ve-kultusza
Jahvén	jah-vén
Jahvéról	jah-véról
Jahvét	jah-vét
Jakob Bekenstein	dzsékob békönsztín
Jaksity	jakshics
Jaltában	jaltában
Jamamoto	jámá-motó
Jame	dzsém
James	dzsémsz
James Clerk Maxwell	dzsémsz klörk mekszvel
James Cook	dzsémsz kúk
James Jeans	dzsémsz dzsínsz
James Watson	dzsémsz vátszon
James Watt	dzsémsz vatt
James Woodville	dzsémsz vúdvill
Jamie James	dzsémi dzsémsz
Janak	dzsánák
Jane	dzsén
Jane Austen	dzsén ósztin
Janeiro	zsánejró
Jang	jáng
Janina	dzsánina
Janinát	zsáninát
Jankovich	janko-vics
Janowitz	dzsenövitc
Janta	jan-ta
Janus	jánusz
Janus Pannonius	jánusz pannóniusz
Janx	dzsánksz
Jány Gusztáv	jányi gusztáv
Jared Kushner	dzsered kush-ner
Jarenba	dzsárenba
Jaronda Askew	dzsáronda eszkjú
Jaroszlav	jároszláv
Jaroszlaw	jároszláv
Jasenko	jásenkó
Jasmin	dzsezmin
Jathribba	játribba
Javier Olivan	hávier oliven
Javits Centerben	dzsévitc szenterben
Jawiszowice	jáviszovice
Jayant Narlikarral	dzsájánt nárlikárral
Jaycee	dzséjszí
Jazid	jázid
Jazilj	jázilj
Jean	zsan
Jean Bart	zsán bárt
Jean-Jacques Rousseau	zsán-zsákk russzó
Jean-Marc Levy-Leblond	zsanmárk lévi-löbland
Jeanneney	dzsenönéj
Jeff	dzseff
Jeff Chester	dzseff cseszter
Jeff Zientst	dzseff tcíntszt
Jefferis	dzsefríz
Jefferson	dzsefferzon
Jeffrey Harvey	dzsefri hárvi
Jelasics	jelashics
Jelasity	jelashics
Jellasics	jelashics
Jellicoe	dzselikő
Jelzt	jelz-t
Jemappes	zsömáp
Jenan	jenán
Jenner	dzsenör
Jennifer	dzsenifer
Jenny Beth Martin	dzseni besz mártin
Jeopardy	dzsepödi
Jeremiah	dzseremájá
Jeremy Bernstein	dzseremi börnsztín
Jérome Napoléonnak	zsérom napóleonnak
Jerry Lyonsnak	dzserri lijonsznak
Jerry Yanggal	dzseri jáng-gal
Jersay	dzsörzi
Jersey	dzsörzi
Jervis	dzsörvisz
Jeses	dzsízösz
Jessica Hertz	dzsesszika hertc
Jesua	jeshua
Jesus	dzsízösz
Jevon	dzsevon
Jews	dzsúz
Jewsh	dzsúish
Jezabel	dzsezábel
Jiang	dzsijáng
Jian-Hóban	dzsiján hóban
Jimet	dzsimet
Jimmy Adamick	dzsimi edömik
Jimmy Kimmel	dzsimi kimmel
Jing Cseng	jing cseng
JLS	dzséjelesz
JNFAFT	jé-en-eff-á-ef-té
Joachim	joá-him
Joachim Winckelmann	joá-chim vinkölman
Joanna Seringtől	dzsoána szeringtől
Joannes Duns Scotus	dzsoánsz dánsz szkötász
Jobs	dzsóbsz
Jock Colville	dzsok kólvil
Jodie Foster	dzsodi foszter
Jodl	jódöl
Jodrell Bank Observatoryban	dzsordel bánk obszőrvötriben
Joel	dzsoel
Joel Manton	dzsoel mántön
Joel Primack	dzsoel prájmek
Joel Scherk	dzsoel shrek
Joffre	dzsofré
Johann Caspar Ampringent	yohán kászpár amprazsón
Johann Karl Unger	jo-hán kárl un-ger
Johann Ulrich	joh-án ul-rik
Johannes	johánnesz
Johannes Droste	johánnesz drószt
Johannes Dubravius	yohá-nnesz dubráviusz
Johannes Kepler	johánnesz kepler
Johannesburgban	yohánnesz-burgban
John	dzsón
John Anderson	dzsón enderszon
John Hampden	dzsón hempdön
John Jaytől	dzsón dzséj
John Martin	dzsón mártin
John Maynard Keynes	dzsón májnárd kéjnsz
John Passacantando	dzsón pásszákántándó
John Watson	dzsón vátcon
Johnny Carsont	dzsoni kárszont
Johns	dzsónsz
Johnson	dzsonzon
Joinville	dzsójnvill
Jomard	dzsomárd
Jonathan	dzsonátán
Jonathan Burnham	dzsonátán börnhem
Jonathan Greenblatt	dzsonátán grínblátt
Jonathan Harker	dzsónátán hár-ker
Jonathan Harrison	dzsónátán heriszon
Jonathan Leibowitz	dzsónátán lejbovitc
Joncairs	dzsonkerz
Jones	dzsónsz
Jones College	dzsónsz kálidzs
Jorge Luis Borges	horhe lujíz borhíz
Jose	dzsóz
José	hozé
Jósé	hozé
Josef	jo-zef
Josef Mengele	jo-zef mengele
Josehpus Flavius	jozefusz flávijusz
Joseph Biden	dzsozef bájrön
Joseph Chamberlain	dzsozef csembörléjn
Joseph Glanvil	dzsozef glenvil
Joseph Strauss	jozef shtrausz
Joseph Yablonski	dzsozef jáblonszki
Josephine	zsozefin
Josephus	jozefusz
Josephus Flavius	joze-fusz fláv-iusz
Josiah	dzsoszájáh
Josip Broz Tito	joszip brotc tító
Joszip Jelasicsot	joszip jelashicsot
Jovan	jován
Jovianus	jovijánusz
Jovo Jovanovic	jovó jová-novics
Józef	jo-zef
JSTOR	dzséjesztíöár
Juan	huán
Jüan	juán
Juárez	huárez
Juda	júda
Júdát Sesonk	júdát szeszonk
Júdeábán	júdeában
Judeára	júdeára
Judge	dzsádzs
Judy	dzsudi
Jugurtha	jug-urta
Jugurthát	jugurtát
Juin	zsüván
Juint Murphyvel	dzsűn mörfi
Jules	zsüll
Jules Ferry	zsüll ferri
Jules Grévy	zsüll gréjvi
Jules Mazarin	zsüll mázárin
Julia	júlia
Julian	juliján
Julián	juliján
Julianus	julijánusz
Jülichnél	jűlihnél
Julier	júlijer
Juliet Johnson	dzsuliet dzsónzon
Julio	húlió
Juliónak	húliónak
Juliskával	julis-kával
Julius	dzsúliusz
Julius Caesar	júliusz cézár
Julius Caesar Octavianus	júliusz tcézár oktáviánusz
Julius Caesaréihoz	júlijusz tcézáréjihoz
Julius Nepos	júlijusz neposz
Junius Brutusnak	júnijusz brútusznak
Juno	júnó
Juntát	huntát
Juntz	júnc
Junzt Unausprechlichen Kulten	júnc únausz-spreklihen kúlten
Jupiter	jupi-ter
Jura	júra
Juridisch-Politischer Leseverein	juridísh-politísher lezöverín
Jurij Andropov	juríj ándropov
Jurisics	yurishics
Justinianus	jusztívijánusz
Kabul	ka-bul
Kadiphonek	kádifonek
Kadmeiába	kadmejába
Kadzsuraho	kádzsuráhó
Kafarnaum	káfárnáum
Kahlenberg	kálen-berg
Kahlo	káló
Kahn	kán
Kahr	kár
Kahrnak	kárnak
Kahuna Burgeres	kahúna börgörsz
Kairosz	kájrosz
Kaiser	kájzer
Kaiser Wilhelm	kájzer vilhelm
Kalasnyikovokkal	kalasnyikowokkal
Kalendae	kálendáje
Kalikut	kali-kut
Kalka	kálká
Kállay	kállai
Kalliász	kallijász
Kallimakhosz	kálimákhosz
KALOT	kálot
Kalugin	kalu-gin
Kaluza	kaluza
Kaluza-Klein	kaluza-klejn
Kamakura	kama-kura
Kaman-Thah	kámán táhe
Kamioka	kamijóka
Kammhuber	kám-húber
Kanadába	kana-dába
Kandahar	kandahár
Kang-Xing	káng sháng
Kansas	kenzesz
Kansasba	kenzeszbe
Kant	kánt
Kapelsen	kepölszen
Kaplan	keplen
Kapodisztriast	kapodi-sztriászt
Kapp	kápp
Kara Ibrahim	kara ibra-him
Kara Swisher	kárá szvisher
Karamazov	karam-azov
Kardashianok	kárdáshiánok
Kardasov	kardashov
Kari Marx	kárl márksz
Karib	karib
Karkemis	kárk-emisz
Karl	kárl
Karl Ernst	kárl ernszt
Karl Hausho	kárl hauszhó
Karl Mansfeld	kárl mánsz-feld
Karl Marx	kárl marksz
Karl Schwarzschild	kárl shvartcshíld
Karlosz	kárlosz
Karlovics	kárlovics
Karlsbad	kárlszbád
Karnak	kar-nak
Karolina	karo-lina
Karoling	karo-ling
Kárpathosz	kárpátosz
Karsra	kars-ra
Kartagéna	kártá-héná
Kasgáriát	kászgáriját
Kashmir Hill	káshmir hill
Kassel	kásszel
Kasselben	kásszelben
Kasszandrához	kasz-szandrához
Kate Losse	kéjt losszi
Katherine	kétrín
Kathryn Montgomeryt	ketrin montgomerrit
Katie Couric	keti kurik
Katiny	kátyin
Katy Perry	kéjti perri
Katyn	kátyin
Katz	kátc
Kavanaugh	kevenó
Kavarna	kavarna
Kaye	kéj
KDNP	kádéenpé
Keats	kítc
Keck	kekk
Keiji Kikkawa	kejdzsi kikává
Kelemen	kel-emen
Kelet-Karélfába	kelet karélijába
Kellermann	keller-mann
Kellog Hansen	kelog henszen
Kellogg	kelog
Kellogg-Briand	kelog brájend
Kelly Rogers	keli rodzsersz
Kellyanne Conway	kelien konvéj
Kempen	kem-pen
Kempis	kempisz
Kendall	kendel
Kennedy	kenedi
Kenneth	kenet
Kenneth Libbrecht	kenet líbrekt
Kenneth Pendar	kenet pendör
Kenosha Guard	ken-osha gárd
Kenoshai	kenosha-i
Kenton	kentön
Kentucky	kentáki
Kentuckyban	kentákiban
Keonig	keöring
Kerr	kerr
Kerry	kerri
Kerstetter	kersztetter
Kesselring	kesszelring
Ketel	ketel
Kéthly	kétli
Kevin Martint	kevin mártint
Kevin Systromot	kevin sisztomot
Kevlar	kev-lár
Keystone	kísztón
Khaiber	kajber
Khalkidikét	kalki-dikét
Khephrén	kefrén
Khitteus	kitteusz
Khiweust	kíveuszt
Khomeini	komejni
Khuen	qen
Khutalfalvi-Darus	kutalfalvi dárusz
Kidogo	kidogó
Kikkawa	kikává
Kilian Lukács	kilián lukács
Kimberley Emberg	kimberli imberg
Kimberly	kimberli
King	king
King George	king dzsórdzs
King James	king dzsémsz
Kingsport	kingszport
Kinjikitile Ngwale	kinnyiketíle ngvále
Kira	kíra
Kiran	kiren
Kirk Douglas	körk dáglesz
Kirkenes	körkönsz
Kirkland	körklend
Kirkpatrick	körkpetrik
Kirkwall	körkvál
Kirshner	kirshner
Kisinyov	kisinyov
Kissinger	kiszin-dzser
Kistiakowsky	kisztyakovszki
KISZ	kisz
Kitt Peak Observatoryban	kit pík obszörvötriben
Kitty Bennett	kitti benett
Kjóto	kjó-tó
Klara	klárá
Klára	klárá
Klaus	klausz
Klava	kláva
Kled	kled
Klein	klejn
Klement	kle-ment
Kleopatrát	kleo-pátrát
Kleophón	kleofón
Klessheim	klessz-hejm
Kleve	kléve
Klim	klim
Klingsor	kling-zor
Klobuchar	klobácsár
Klopper	klop-per
Klupath	klápász
Klux Klán	kluksz klán
Kmety	kmeti
KMPG	káempégé
KNEP	knep
Knezevic	knezevitc
Knightsbridge	nájtsz-bridzs
Knipping	knipping
Knob Hill	nob hill
Knox	noksz
Knudsen	knudz-dzen
Knut	knút
Koba	ko-ba
Koblenzig	koblencig
Kock	kokk
Koestler	kösztler
Kofman	kofmen
Kogalniceanu	kogálnicsánu
Kogan	kogn
kogge	kogg
Kohl	kól
Kola	kóla
Kolhoester	kolhöszter
Kolka	kol-ka
Kollonich	kollonics
Kollontaj	kolontáj
Kolman Czito	kólen tcító
Komarno	komárnó
Kommissarbefehl	komisszárbefél
Kompolthy	kompolti
Komputer	kompjúter
Komputere	kompjúterre
Kondo	kondó
König	kőnig
Königlich	kőnig-lich
Königsbergben	kőnigsz-bergben
Königsgraben	kőnigszgráben
Konrad	konrád
Konstantin	konst-antin
Konstantin Fotitch	konsztantin fótics
Kopits	kopics
Korall	kor-all
Koreára	kóreára
Kórinthosz	korintosz
Korjo	korjó
Kosciuszko	kosz-sziuszkó
Kosovo-Metohija	koszovó metohija
Kossuth	kosút
Koszovo	koszovó
Kosztroma	koszt-roma
Koth	kót
Koum	kúm
Kozlov	holz-lov
Kraffhoz	kraffhoz
Krának	krának
Kratochwill	kratocs-vill
Krauss	krausz
Kravec	krávec
Kreml	kreml
Kremsierbe	kremzírbe
Krendlemek	krendlernek
Kresznerics	kresznerics
Krieger	kríger
Kriegführung	kríg-fűrung
Kriegsgefangene	krígsz-gefángene
Kriegsmarine	krígsz-máríne
Krikket	krikett
Kristiansandnál	krisztijen-sztándnál
Kristopher Tillery	krisztofer tilöri
Krobatin	krobátin
Królewska	królevszka
Krom	krom
Kronstadt	krón-státt
Kronstadtba	króm-státtba
Kronstadtban	krón-státtban
Kropotkin	kropot-kin
Krüger	krűger
Krum	krúm
Krúmpszt Fala	krúmszt fa-la
Krupp	krúpp
Ktésziphont	ktészifónt
KTI	káté-í
Kuang	kuáng
Kübeck	kübek
Kubik	kub-ik
Küküllei	kükülleji
Kulturkampf	kultúr-kámpf
Kunó	kúnó
Kuomintang	kuo-mint-áng
Kurais	kurájisz
Kuranes	köránesz
Kurt	kört
Kurt Zeitzlernek	kurt cájclernek
Kurzeme	kurzémje
Kushnerrel	hushnerrel
Kustomert	kásztömert
Kütahyába	kütáhijába
Kutrzeba	kurceba
Kynarathalis	kinárátálisz
Kynarthot	kinártót
Kyros	kűrosz
Kyrst	kürszt
Kythamil	kitámil
L’ Allemagne paiera tout	elálemány perá tú
La Guardia	lágárdijá
La Manche	lámáns
La Passionaria	lá pásszijonáríjá
la Pucelle	lá pucselle
Laborde	lábörd
Lachaise	lás-ez
Ladoga	lad-oga
Lady Dianának	lédi dájánának
Laenas	lénász
Lafayette	láfájet
Lagardell	lögárdöl
Lagas	lágász
Lager Monowitz	láger monovic
Lagerpolizei	láger-policáj
Lagoson	lagoszon
Lagrange	lágrándzs
Laibachban	láj-bach-ban
laissez faire	lészé ferr
Lala Mehmed	lálá meh-med
Lalamatine	lala-matín
Lamar	lámár
Lamartine	lömártín
Lamberg	lám-berg
Lambert	lámbert
Lamoreaux	lámorő
Lamp Company	lemp kámpöni
Lancaster	lenkeszter
Lancasterek	lenkeszterek
LANCEA REGIS	lánkeá regisz
Landau	lan-dau
Landerer	lan-derer
Landler Jenő	land-ler jenő
Landriano	lándriánó
Landsdowne	lendszdáun
Landtag	lándtág
Landwehr	lánd-ver
Lane Craig	lén kréjg
Lane Poor	lén púl
Langham	láng-hám
Langhorne Clemens	lenghórn klemensz
Langley	lengli
LANGLEYBE	lenglibe
Lansdowne	lándszdáun
Lansing Municipal	lenszing muniszipál
Lant Pritchett	lent pricset
Lantos	lan-tos
Laon-Soissons	láón szoászónsz
Laplace	láplász
Largo Caballero	lárgó kábájjeró
Larry Niven	leri níven
Larry Page	lerri péjdzs
Larrynek	lerrinek
Larsen	lárszen
Las Vegas	lászvegász
Las Vegasszal	lászvegász-szal
Lascelles	lászölz
Laser Interferometer Gravitational-Wave Observatory	lézör intergerométer gravitéjsönöl obszőrvötri
Laser Interferometry Space Antenna	lézer interferometri szpész ántená
Lassalle	lászál
Lateranus	láteránusz
Latium	lacíjum
Latona	lato-na
Lattre	látrö
Laud	laúd
Laudalo	laudáló
Laue	lau-i
Lauffen	laufen
Launch	láuncs
Laura	lorá
Laurá	lorá
Laura Murphyt	lora mörfi
Laurelwoodot	lorel-vúdot
Laurie Segallt	lori szegált
Lausanne	lüzánn
Laval	lávál
Lavoro	lávorró
Lavr Kornyilov	lávr kornyilov
Lawrance Ford	laurensz ford
Lawrence Livermore National Laboratoryban	laurensz livörmór nesönel labratoriben
Lawrence Suliivan	laurensz száliven
Lawrence Summers	lau-rensz számörsz
Lawson	lószon
Laycock	léjkák
Lazlar Lyricon	lázlár lürikon
LB	elbé
Le Havre	löávrö
Leadership Conference	lídörship konferensz
Leah Pearlman	lí pörlmen
Leahy	líhi
Leathers	ledörsz
Lebensraum	lébensz-raum
Lebrun	lebrön
Leclerc	löklerk
Lecter	leh-ter
Ledru-Rollin	lödrü rolan
Leeb	lé-éb
Leeds	lídsz
Lefort	löfort
Legio	légió
Lehmann	léman
Leibniz	lejbnitc
Leibowitz	lejbovitc
Leiche	lájhe
Leigh-Mallory	líj málori
Leila	lejla
Leissnert	lájsznert
Lelag-Leng	leláng leng
Leletko	leletkó
Leljusenko	leljusenkó
Lemaitre	lömetr
Lemuria	lemúrija
lend lease	lend líz
Lendvai-Bainton	lendvai bájnton
Leng	leng
Lenkey	lenkei
Lennie	leni
Leon	león
Léon Blum	léon blúm
Leonard	leo-nárd
Leonard Susskind	lenörd szászkind
Leonardo	leonárdó
Leonardón	leonárdón
Leone	leóne
Leonhard Euler	lenonárd ójler
Leónidasz	leonidász
Leonira	leonírá
Leonora Christine	leonor krisztín
Leotükhidasz	leotükidász
Lepidus	lepidusz
Leptisnél	leptisznél
Lesbiához	leszbijához
Leslie Howard	lezli haovárd
Lester Holt	leszter holt
Leszczynski	lesz-tzinszki
Letchworth	lecs-vörsz
Letitia James	letisha dzsémsz
Letterman	letörmen
Leuven	löven
Levy	liváj
Levy Wash	lévi vas
Lewandowski	levándovszki
Lewis	lújisz
Lewis Carroll	lúisz kerol
Lex Salica	leksz száliká
Leyla	lejla
Leyte	lejt
LHC	elhácé
Liangsan	lijáng-szán
Liber	líber
Libertate	liber-táte
Libra	libra
Librevilleben	líbrevillben
Licata	likátá
licentia ubique docendi	licencijá ubík docendi
Liciniae Sextiae	litcinijé szeksztijé
Licinius Crassus	lutci-niusz krasszusz
Lick Observatory	likk obszőrvötri
Lida	li-da
Liebknecht	líb-knekt
Liége	lijezs
Lieseral	lizerál
Life	láyf
Lige	lijezs
Light	lájt
LIGO	ligó
Likud	líkud
Lilburne	lil-börn
Lillet	lílet
Lillian	lilijen
Lima News	líma nyúz
Lincoln	linkoln
Lindbergh	lind-berg
Linder	lind-er
Lindsey Graham	lin-dzi grehem
Linear Accelerator Center	liniör ökszelerétör szenter
Lingayeni	lingejni
Lingua Centaurin	lingva kentaurin
Lipset	lipszet
Lipskit	lipszkit
LISA	lisza
Lisa Randall	liza rendel
Lise Meitner	liz mejtner
Lissánál	lizzánál
Liszenko	liszenkó
Little	litöl
Littorio	littórijó
Livadia	livádia
Live	lájv
Livermore National Laboratoryban	levörmór nesönel llebretöriben
Liviának	lívijának
Livingston Parish	livingszton perish
Livius Andronicus	lívijusz andrónikusz
Liviusnak	lívijusznak
Liza	li-za
LMP	elempé
Locarno	lokárnó
Locarnó	lokárnó
Locarnóban	lokárnóban
Locarnót	lokárnót
Loch	lokk
Locke	lokk
Lockheed	lokhíd
Lodgepole	lodzs-pól
Lodovico	lodovíkó
Lodovico Gritti	kodovíkó grit-ti
Loggia	lodzsa
Loire	loár
Loki	lo-ki
Lola Montezhez	lolá montezhez
Lomar	lomár
Lomax	lomaksz
Lombardia	lombardija
Lombardiából	lombardiából
Lone	löün
Long Island	long ájlend
Longinus	longinusz
Longwy	longvi
Lónyay	lónyai
Loolu	lúlu
Lopez	lop-ez
Lord Cardigan	lord kardigán
Lord Castlereagh	lord kászölöre
Lord Dunsany	lord dánszöni
Lord Kelvin	lord kelvin
Lord Palmerston	lord pálmerszton
Lord Raglan	lord ráglán
Lord Ravlight	lord réjlájt
Lord Raylcight	lord réjlájt
Lord Rayleight	lord réjlájt
Lordnak	lord-nak
Lorentz-Fitzgerald	lorentc fidzseráld
Lorenzo	lorenzó
Lorient	lorijan
Los Angeles	losz ándzselesz
Losse	losszi
Lothar	lotár
Lothian	lótijen
Lough Gill	láf zsill
Louhce Raymon	lúhsz réjmon
Louis Barthou	lují bártó
Louis Montesquieu	lují monteszkijő
Louis Mountbatten	lují máuntbátön
Louis Pasteur	lují pásztőr
Louis-Auguste Blanqui	lují ogüszt blankí
Louisiade	lujizijád
Louisiana	lújzijáná
Louisianában	lujzijánában
Louisianát	lujzijánát
Louisville	lujivill
Lound	láund
Lounds	láundsz
Lounds Lincoln Versailles	láundsz linkoln verszáj
Lounge	londzs
Lousville	lujivill
Louvain	lűven
Louvois	lövoá
Louvre	lúvrö
Love	láv
Lovecrafté	lávkráfté
Lovecraftiana	lávkráftijáná
Lovecraftnak	lávkráftnak
Lovecraftot	lávkráftot
Lovelance	lávlensz
Lowenstein	lóen-stejn
Lower Regent Streeten	lóer rédzsönt sztríten
Lowrance	lorensz
Loyola	lojola
LSD	elesdé
Lübeck	lübek
Lublin	lub-lin
Luca	luká
Lucanust	lukánuszt
Lucasfilm	lukászfilm
Lucasian	luükázián
Luccia	lúcsija
Lucie	lúcsije
Lucius	lútcijusz
Lucius Tarquinius Superbus	lutsiusz tárkíniusz szuperbusz
Lucius Tillius Cimber	lutciusz tilliusz tsimber
Lucretia	lukrécija
Lucullus	lukullusz
Ludwig Boltzmann	ludvig boltcman
Ludwig Börne	ludvig börn
Ludwig Cobenzl	ludvig kobenszl
Ludwig Erhard	ludvig erhárd
Ludwig Erhardt	ludvig er-hárt
Ludwig Feuerbach	ludvig fójer-bach
Ludwig Freude	ludvig frójde
Ludwig Prinn	lúdvig prin
Ludwig Wittgenstein	lidvig vitgenshtejn
Luftwaffe	luft-váffe
Luftwaffénak	luft-váffénak
Luftwaffét	luft-váffét
Lugdunum	lug-dunum
Lugos	lúgos
Luitpold	lujítpold
Lukianosz	lukiánosz
Lula	lúla
Lumdra	lumdra
Luna	lúna
Lüneburgi Fenyéren	lűneburgi fenyéren
Lunéville	lünevil
Lungarno	lun-gárnó
Lungarnó	lun-gárnó
Lunkwill	lánkvil
Lupa	lúpa
Lupercusok	luperkúzoszok
Lury	löri
Lusitania	luzitánia
Lusitaniát	luzitániját
Luther Burbank	lut-er börbenk
Luther King	lu-ter king
Lütjens	lűtjensz
Luxembourg	lukszenburg
Luxemburg	luxem-burg
Lwów	lövóv
Lycra	likra
Lycrá	likrá
Lyme Regis	lím rézsísz
Lympne	límpn
Lyndon	lindon
Lynehamből	linhemből
Lynton	linton
Lyon	lijon
Lyonban	lijonban
Lysanderből	lizánderből
Lyttelton	littelton
Maas	mász
Maas-Antwerpen	mász ant-verpen
Maas-Leuven-Antwerpen	mász lőven ant-verpen
Maason	mászon
MAC	mek
Macarena	mákáréná
Macarená	mákáréná
Macarthur	mekártúr
Macartney	mekkártni
Macaulaytól	mekólitól
Macaura	mákura
Macdougall	mekdágöl
Machiavelli	mákjávelli
Machina	máhíná
MACHO	mácsó
Machu Picchura	macsi picsura
Maci Laci	maci-laci
Mackenzie	mekenzí
Mackenzie Kinget	mekkenzi kinget
Maclean	meklén
Macmillan	mekmilen
Macmillannek	mekmilennek
Maconbe	mákomb
Macrinus	mákrinusz
Macron	mákron
Macugava	mácu-gává
Macuoka	matcu-óka
Macuokát	matcu-ókát
Madame	mádám
Madame Curie	mádám kürí
Madeira	mádejrá
Madelyn	medlin
Madison Square Garden	mediszon szkver gárdön
Madonna	mado-nna
Madras	mádrász
Maduro	mádúró
Maecenasnak	mtcénásznak
Maecenast	mecénászt
Maffeo	máffejó
Magadha	mag-ada
Magadhának	mag-adának
Magadhára	magadára
Magától	magától
Magdala	mágdálá
Magdalena	magda-léna
Magdelene	mágdá-lén
Magenta	mag-enta
Maghreb	mágreb
Maginot	mázsínó
magister militum	mágiszter milícijum
Magna	mag-na
Magna Graeciának	mag-na grékijának
Magnalia Christi Americanájába	mágnálijá kriszti amerikánájába
Magnentiusnak	mágnencijusznak
Magnészia	magnészija
Magnificó	mányifíkó
Magnum	mag-num
Magnus	mág-nusz
Mago	mágó
Magramal	mágrámel
Magramelről	mágrámelről
Mahabharata	mahaba-rata
Mahábhárata	mahaba-rata
Mahal	má-hál
Mahdi	mádi
Mahiko Suzuki	máhikó szuzuki
Mahoney	máhoni
Mainban	májnban
Mainzban	májncban
Maison Blanche	mezón blansh
Maison Rouge	mézön rúzs
Maitland	méjtlend
Majikhtise	mádzsiktisz
Majikthise	mádzsiktisz
Maji-Maji	mági mági
Majmonidész	majmonidész
Major	méjdzsör
Majubáért	májubáért
Makeda Wubneh	mákedá vubneh
Makkabeus	maka-beus
Makkabeusnak	maka-beusnak
Malabar	málábár
Malajzia	malaj-zija
Malaves	málávesz
Malaya	málájá
Malaysiából	malajzijából
malenkij robot	málenkíj robot
Malenkov	málenkov
Malka	malka
Mallen	mállen
Mallorcán	majorkán
Malmédytől	málméditől
Máltát	máltát
Maltby	máltbi
Mamertinus	mámárcínusz
Manből	menből
Manche	máncs
Manchester	mencseszter
mancipium	máncípijum
Mandalajban	mándálájban
Mandel	mándel
Mandich	mándics
Mandics	mándics
Mandrel	mendröl
Mandy	mendi
Mandzsukuo	mándzsukó
Mane	mén
Manethón	máne-tón
Mang	máng
Manhattan	menhetten
Manhattanben	menhettenben
Manifesto	mánifesztó
Mannerheim	mánner-heim
Mannheimer Zeitung	mánnhejmer tzájtung
Mannstein	mánn-stejn
Mans	man
Manstein	mán-stejn
Manston	mánszton
Mant	ment
Mantes	mant
Manton	mánton
Mantova	man-tova
Manuel Silva	mánuel szilvá
Manuelerődöt	mánuel erődöt
Manufacturing	menöfekcsöring
Many Dimensions	meni dájmenzsönsz
Mapp	mápp
Mapquest	mápkveszt
Maquis	mákí
Marat	márát
Marathon	mara-ton
Marble Head	márböl hed
Marc Andreessen	márk endresszen
Marc Benioff	márk bejnoff
Marc Bodnick	márk bodnik
Marcel	márszel
Marcel Grossmann	márszel groszmen
MARCELL	márszel
Marcellinus	márcellínusz
Marcellus	mártcellusz
Marcelo Fuhrman	márcselló fűrman
March	márcs
Marchand	márshan
Marche	mársh
Marché	mársé
Marcia su Roma	márcsijá szu rómá
Marciának	mársának
Marciasu	márszijászku
Marciát	mársát
Marcius	már-cius
Március	március
Márciusi	mártciusi
Marco	márkó
Marconi	márkóni
Marcus	márkusz
Marcus Antonius	márkusz antóniusz
Marcus Brutus	márkusz brútusz
Marcus Junis Brutus	márkusz júnisz brútusz
Marcus Octavius	márkusz oktávijusz
Marcus Vispasianus	márkusz viszpáziánusz
Mardoniosz	márdónijosz
Mareth	máret
Margaret	márgáret
Margaret Geller	márgáret gel-ler
Margaret Thatcher	márgáret szecsör
Margerie	márdzsöri
Margivalban	márdzsivölben
Marguerite Schmitt	márgáret smitt
María	máríjá
Maria Antoinette	márí ántoánett
Marian	merijen
Marian Rejewski	máriján redzsevszki
Marica	mar-ica
Marie	márí
Marie Antoinette	márí ántoánett
Marienburgban	márijen-burgban
Marigny	márini
Marija	máríjá
Marilyn	merilin
Marinidák	márinidák
Maris	márisz
Marissa Mayer	márisszá mejer
Marius	márijusz
Mark	márk
Mark Twain	márk tvéjn
Mark Warnerrel	márk vórnerrel
Mark Zucker	márk cukker
Mark Zuckerberg	márk cukkerberg
Market	márket
Markheim	márk-hejm
Markizova	márkizova
Marlborough	marl-boró
Marmontel	mármontel
Marne	márn
Marois	mároá
Marquis Chasteler	márkí shásztöler
Marrákes	márákes
Marrakesben	mara-kesben
Marrakesből	márákesből
Marrakest	márákest
Marry Plummert	mári plámört
Mars	mars
Marshfield	márshfíld
Marston	mársztón
Martha	mártá
Marthy	márti
Martin Gardner	mártin gárner
Martin Luther King	mártin lu-ter king
Martin Rees	mártin ríz
Martinec	mártinek
Martinique	mártinik
Martinuzzi	mártinudzzi
Martis	mártisz
Martius	márciusz
Marvells	márvelsz
Marx	marksz
Mary College	méri kálidzs
Maryland	merilend
Marzuki Darusman	márzáki dáröszmen
Masaccio	mázáccsó
Masami Yamasaki	mászámi jámászáki
Masaryk	mázárik
Mason	mézön
Massachusetts	meszecsúszetsz
Massachusettsben	meszecsúszetszben
Massimo Stivavelli	másszimó sztivávéli
Massinissa	másszinisszá
Massive Compact Halo Object	messzív kámpekt héló ábdzsekt
Mastama	masztama
Mastarnáról	masztarnáról
Matapan	mátápán
Mathews	mettyúz
Matrúhba	mátrúba
Matrúhnál	mátrúnál
Matt Cohler	mett kólen
Matt Damon	mett démon
Matt Danzeisen	mett denszízen
Matt Schissler	mett shiszler
Mattathiásnak	máttátijásznak
Matteo	mátteó
Matteo Villani	máteó villáni
Matteottit	mátte-ottit
Matter	mettör
Matthew	mettyú
Matthew Perry	mettyú perri
Matthews	mettyúz
Matthys	mátísz
Matuska	mat-uska
Mauer	mau-er
Mauna	ma-una
Maupas	mopá
Maupassant	mópásszan
Maupertois	mópörtoá
Mauritius	maurítziusz
Maurja	maujra
Mauthausen	maut-hauzen
Mauthhausen	maut-hauzen
Maverhill	mevörhill
Mawson	mószon
Maxentius	mákszencijusz
Maxet	mekszet
Maxim	mákszim
Maximianus	mákszimijánusz
Maximilien Robespierre	mekszimilijen robeszpijer
Maximus	mákszimusz
Maxine Waters	mekszin vótörsz
Maxine Williamset	mekszin vilijemszet
Maxi-Slorta	makszi-szlorta
Mayapan	májápán
Mayernek	mejernek
Mazarin	mázárin
Mazzarini	mádzzáríni
Mazzini	máddzíni
MCCLANE	mekléjn
Mcilvenna 	meklíverná
MDF	emdéef
MDNP	emdéenpé
Mechanics	meköniksz
Mecklenburgba	meklenburgba
Medici	medicsi
Mediciek	medicsiek
Medina	med-ina
Mediolanumban	medio-lánumban
Mediolanumot	medijolánumot
Meditermaeum	mediterráneum
Mediterraneum	mediterráneum
Mediterrnaeum	mediterráneum
MEDLKFMI	em-e-dé-el ká-ef-em-í
Medzsid	medzsid
Meeks	míksz
Megara	megárá
Meggido	megid-dó
Meggidót	megid-dót
Mehmed	meh-med
Meidzsi	mejidzsi
Meiktila	mejktilá
Mein Kampf	májn kámf
Mein Kampfom	májn kámfom
Mekcsey	mekcsei
Mekka	mek-ka
Mekkát	mek-kát
Melanchton	melánk-ton
Melania Trump	meláni trámp
Melbourne	melbőrn
Melinda Gates	melinda géjtsz
Melissa	melissza
Mellon	melön
Melqart	melkár
Memel	memmel
Memeptah	memep-tá
Memorandum	memo-randum
Memorial	memorijál
Memphis	memfisz
Memphisben	memfiszben
Memphisz	memfisz
Memphisznél	memfisznél
Memphiszt	memfiszt
Menandrosz	menandrosz
Mendelssohn	mendelzon
Menés	ménész
Mengel	men-gel
Menlo	menló
Menlo Park	menló park
Menton	mentön
Mercia	merszija
Mercier	mörszijé
Mercurii	merkúrí
Mercurius	merkúriusz
Mercury Grand Marquis	mörkjuri grán márkez
Mercy	mörszi
Merida	meri-da
Merkclt	Merkelt
Merkur	merkúr
MERLIN	merlin
Merseburg	merze-burg
Mersey	mörszi
Mertz	merrtz
Mésa	mésa
Meseritz	mezeric
Messaginget	meszödzsinget
Messalinát	messzálínát
Messenger	meszendzser
Messiah	messzájá
Messina	messzina
Messinában	messzinában
Messor	messzor
Messzénia	mesz-szénija
Messzéniába	mesz-szénijába
Messzéniát	messzéniját
Mester	mester
Metcalf	metkálf
Metcalf-Barnes	metkálf bárnsz
Metcalfot	metkálfot
Methods	metodsz
Metis	metish
Metropolitan	metropoliten
Metternich	metter-nih
Mettrie	metrijé
Metzbe	metc-be
Metztől	metc-től
Meurice	mürisz
Meuse	mőz
Meyrick Clifton James	mejrik klifton dzsémsz
Méziéres	mezijer
MFB	emefbé
MHB	emhábé
MI	emmi
Miami	májámi
Mianmar	mijánmár
Michacl Collinst	májköl kolinszt
Michael	májköl
Michael Bywaternek	májköl bájvóternek
Michael Codner	Májköl kodnör
Michael Corleone	májköl korleóne
Michael Faraday	májköl feredéj
Michael Flynn	májköl flinn
Michael Gove	májköl góv
Michael Lynton	májköl lin-ton
Michael Morris	májöl morisz
Michael Nankin	májköl nánkin
Michael Phelps	májköl felbsz
Michael Redgrave	májköl redgrév
Michael Trevane	májköl trivéjn
Michael Turner	májköl törnör
Michael Zucker	májköl tcukker
Michaelson	mikáelszon
Michaelson-Morley	mikáelszon-mórli
Michailovic	mihájlovics
Micheal	májköl
Michel	mishel
Michelangelo	mikelándzseló
Michelier	miselijé
Michell	micsel
Michelle	mi-sel
Michelnek	miselnek
Michelt	miselt
Michigan	micsigen
Michiganben	micsigenben
Michnay	miknai
Mickiewicz	mikijevitc
Microsoft	májkroszoft
Middlebury	midöl-böri
Midi	mi-di
Midrás	midrász
Miesko	mijeszkó
Mieszko	mijeszkó
Miggs	migsz
Miguel Alcubierre	migel álkubír
Miguel Serveto	migel szervetó
Mihajlo Idvorski Pupin	mihájló idvorszki pápin
Mihajlovic	mihájlovics
Mihajlovie	mihájlovics
Mihállyal	mihájjal
Mike	máyk
Mike Green	máyk grín
Miklas	miklász
Mikojan	mikoján
Mikolajczyk	mikolájcsik
Miközben Columba	miközben kolumbija
Miksának	miksának
Mikus	mik-ush
Miles Lampson	májlsz lámpszön
Mileva Maric	milevá merik
Milica	milika
Militaire	militer
Military Tribunal	militeri tribünnel
Millan	mili-jen
Miller	mil-ler
Mills	millsz
Milos Obrenovic	milosh obrenovics
Milovan Gyilas	milován gyilás
Miltiadész	miltijádész
Milton Friedman	mil-ton frídmen
Milvius	mílviusz
Mincemant	minszment
Minden-Egyet	minden eggyet
Minerva	miner-va
Minetti	mine-tti
minister Dei	miniszter deji
Minka Kaim	minká kájim
Minkszet	minszket
Minneapolisban	mineápoliszban
Minnesotába	mineszotában
Minnesotában	mineszotában
Minnesotából	mineszotából
Minor Béta	min-or béta
Mint	mint
Minutes	minitsz
Miracles	mirökölz
Miranda	mir-anda
Mircea	mirtceá
Misa	mísa
Mischa	mísá
Misericordia	mizerikórdijá
Miskatonic	miskatonik
Mískatonic	miskatonik
Misna	misna
Misnát	misnát
Misner	miszner
Mississippi	missziszipi
Missouri	misz-szurri
MIT	emájtí
Mithrasz	mitrász
Mithrászt	mitrászt
Mithridatész	mitridátész
Mitterand	mitte-ran
Miura	mjúrá
Mize	májz
MKB	emkábé
MLSZ	emelesz
MNB	emenbé
Mochica	mohika
Model	mo-del
Modena	mo-dena
Modern Scholarship Reinvents	modern szkolör-ship rein-ventsz
Moerbeke	morbéke
Moesia	mőzija
Mogiljov	mogljiov
Mogli	mojji
Mogul	mo-gul
Mogul Birodalom	mo-gul birodalom
Mohan	mo-hán
Mohendzso	mohen-dzsó
Moira	mójra
Mojmír	mojmír
MOL	mol
Molay	moléj
Molly	molli
Moloch	molok
Molocsko	molocskó
Mologyecsnónál	málogyecsnónál
Molokh	molok
Molotov	molo-tov
Molson	mólszon
Moltke	molt-ke
Moltke Sedannál	molt-ke szedánnál
MOMO	momó
Monarchi	monarhi
Monarchia	monarhia
Monarkha	monarha
Mond	mond
Monde	món
Monfalconén	monfálkónén
Monfort	monfort
Monika Bickert	mónika bikert
Moniteur	monitőr
Monnet	moné
Monophthalmosz	monoftálmosz
Monroe	monró
Monroviába	monrovijába
Monst	monszt
Montagu	montá-gú
Montalk	mon-tók
Montana	montáná
Montanába	montánában
Montcalm	món-kálm
Monte Cassino	montekásszínó
Monte Cassinóban	monte kásszínóban
Montecuccoli	monte-kukkoli
Montenegro	montenegró
Montesquieu	monteszkijő
Montgomery	mongo-merri
Monthermé	montermé
Montijo	montihó
Montini	montíni
Montmartre	mónmárt
Montmirailnál	mónmirájnál
Montoireba	montoába
Montrachet	mónráset
Montsalvat	mónszálvát
Montserrat	monszerrát
Monty Python	monti pájtont
Montyt	montit
Monumentum Anchyranumnak	monumentum ánkiránumnak
Moore	múr
Morava	morává
Moravská Ostrava	morávszká osztrává
Morawskit	morávszki
Morea	moreá
Morgan	morgen
Morgartennél	mórgártennél
Morgenthau	morgentau
Moriah	mórija
Mormon	mor-mon
Morrison	moriszon
Morrogh	moró
Morryster	morriszter
Morshead	morszhed
Mortain	mórten
Morus	mórusz
Moselen	mózel
Moselig	mózelig
Moselle	mőüzel
Moshe Dayan	mósh dáján
Mosont	moszont
Mosquito	moszkító
Most	moszt
Moth	moth
Motion Picture Association	mósön pikcsörsz összósiéjsön
Motor World	motor vörd
Motorsnak	motorsznak
Moulin	mulen
Moulton	múlton
Mount Everest	mont evereszt
Mount Pleasantben	máunt plezöntben
Mount Stromlo	mont sztomló
Mount Wilson Observatory	máunt vilzon obszőrvötri
Mountain View	máuntön vjú
Mountbatten	mónbátten
Mouritain	máuritán
Mown	món
Moyne	mójn
Mozart	mótzárt
Mozart 	mócárt
Mozdokot	mozdokot
MPB	empébé
MPK	empéká
MRS	miszisz
MSN	emeshen
MSZDP	em-esz-dé-pé
MSZMP	em-esz-em-pé
MSZOSZ	emeszóesz
MSZP	emeszpé
Mszúsz	mszúsz
Mszúszt	möszúsz
MTA	emté-a
MTA TK PTI	emté-a téká pété-í
Mtalból	mtálból
Mthurán	mturán
MTI	emté-í
MTV	emtíví
Mucius Scaevola	múcijusz szkájevóla
Mufasa	mufasza
Mufasát	mufaszát
Muharram	muhárám
Muhhamed	mohamed
Mühlberg	műl-berg
Mühldorf	műldorf
Muir	muir
Mulvius	mulvijusz
München	münhen
Munda	munda
Munkáspárt	munkás-párt
Münnich	mün-ich
Münster	mün-szter
Münzer	müntzer
Mura	mu-ra
Murat	murát
Murciát	mursziját
Muroideam	mürójdím
Murphy	mörfi
Murray	mörri
Murray Butler	möréj bátlör
Murray Gell-Mann	möréj gell-men
Murray Rothbard	murai rótbárd
Murro	murró
Museo Nacional	múzeó nászijonál
Mussfeld	müszfeld
Mussolini	musz-szolíni
Mussolininak	musz-szolíninak
Mustang	musztáng
Mustapha Mond	musztafa mond
Muthul	mutul
MVM	emvéem
MVP	emvépé
MYRIA	myrija
Myspace	májszpéjsz
NAACP	enéjéjszípí
Nabuccója	nabukkója
NAFTA	nafta
Nagan	nágán
Nagy Bumm	nagy búm
Nagy Constantinus	nagy konsztantínusz
Nagy Constantinusnak	nagy konsztantínusznak
Nagy Homoksivatagban	nagy homok-sivatagban
Nagyfattyúm	nagy-fattyúm
Nagygöncöl	nagy göncöl
Namsosnál	námszosznál
Namsostól Mosjeenbe	námszosztól moszdzsínbe
Namurön	námurön
Nance Garner	nenszi gárner
Nancy	nenszi
Nancyból	nánsziból
Nancynál	nánszinál
Nane	na-ne
Nanna	nan-na
Nano	na-nó
Nansen	nánzen
Nantes	nánsz
Naomi Gleit	náomi glájt
Napoleon	napóleon
Napóleon	napó-leon
Napster	nepszter
Narbonensis	nárboneszisz
Narbonne	nárbon
Narendra Modi	nerendrá múdi
Narew	nárev
Nargis-Heinek	nárgisz hejnek
Narragansett	nárágánszett
Narthos	nártosz
NASA	náza
Nasht	nesht
Natal	nátál
Nathan Rosen	néten rózen
Nathan Rothschild	nátán rótcsíld
Nathaniel	netenijel
Nathaniel Gleicherrel	netenijel glájcherrel
Nath-Horthaht	nát hotát
Nath-Horthath	nát hotát
National	nesönel
National Electric Light Association	nesönel elektrik lájt összósiéjshön
National Enquirer	nesönel inkvájörör
National Gallerynek	nesönel gelörinek
National Geographic	nesönel dzseográfik
National Institute	nesönel insztitút
National Optical Astronomy Observatoryban	nesönel optiköl ásztonomi obszőrvötriben
National Tatiler	nesönel tetler
National Tattler	nesönel tetler
National Telautograph Company	nesönel teleautográf kámpöni
NATO	nátó
Nature	néjcsör
Naujoks	Nójdzsoksz
Nausaia	nau-szijá
Nautilus	nau-tílusz
Navarino	návárrínó
Navarra	návárrá
Navas	návrász
NAVY	néjvi
Nazareth	názáret
Nazca	nászká
Nazione	nátcijóne
Nazioné	nátcijóné
Nazi-Soviet Relations	nátci szovjet riléjsönz
NBC	enbíszí
NBS	enbíesz
Nebraska	nebraszka
Necker	nek-ker
Necronomicon	nekronomikon
Nedeczky	nedetzki
Neebu	níbú
Neervindennél	nervindnél
Neil	níl
Neisse	nejsze
Neisséig	nejszéig
Neissén	nejszén
Neissére	nejszére
Nelson	nelzon
Nelson Oszlopa	nelzon oszlopa
Nelsonra	nelzonra
Nema	néma
Nemo	némó
Nepemiah Derby	nepemájá derbi
Nepos	neposz
Neptun	neptún
NEQ	eníkjú
NER	ne-r
Nero	néró
Nerón	nérón
Neróra	néróra
Nerót	nérót
Nerva	nervá
Nesselrode	nesz-szelród
NET	net
Netscape	netszkéjp
Neufinck	nójfink
Neuilly	nöjí
Neukirchen	nójkir-sen
Neumann	nójman
Neurath	nójrát
Neurophysiology	neuro-pszájkolodzsi
Neustadter	nój-shtátter
Neustria	neusztrija
Neustriához	neusztrijához
Neustriát	neusztriját
Neutron Pörlekedő	neut-ron pörlekedő
Nevel Kingston-Brown	néjvel kingszton bráun
Neveu	növő
Neveu-Schwarz-Ramond	növő-shvartc-rémond
Nevile Henderson	nevil henderszon
Neville Chamberlain	nevil csembörléjn
New Cosmos	nyú kozmosz
New Deal	nyú díl
NEW ENGLAND	nyú inglend
New Historiographical Approach	nyú hisztoriografikál öprócs
New Jerusalem Bible	nyú jeuzsálem bájböl
New Jnternational Version Study Bible	nyú internesönen vörzsön sztádi bájböl
New Testament	nyú tesztöment
Newall	nyú-öl
Newark	nyúárk
Newfoundland	nyúfunland
Newman	nyúmen
Newport	nyúport
News	nyúz
Newsweek	nyúzvík
Newton	nyúton
NGC	endzsíszí
NGO	endzsí-ó
Ngranek	ngránek
Ngwale	ngvále
NHB	enhábé
Nhing	níng
Nibelung	níbellung
Nicaeában	níkeában
Niccoló	nikkoló
Nichiro Nambu	nicsiró námbu
Nicholas	nikolász
Nick Clegg	nikk kledzs
Nickelsburg	nikkelsz-burg
Nickles Adare	nikölsz adár
Nicolas Chauvin	nikolá shovan
Nicole Pinsky	nikól pinszki
Nicolo Pesce	nikólo pes-se
Niels	nílsz
Nielsen	nílzen
Niers	nírsz
Nietzsche	nícse
Nieuwenhuizen	níven-hujtcen
Nieuwpoort	nyúport
Nigel Wilmott	nájdzsel vilmot
Niger	níger
Nijmegent	nájméjgent
Nikatór	nikátór
Niké	niké
Nikephorosz	nikefórosz
Niképhorosznak	nikéfórosznak
Nikiasszal	nikijásszal
Nikiasz	nikijász
Niklas	nikász
Niko	nikó
Nikola Tesla	ni-kola teszla
Nikolat	nikolát
Nikolsburgban	nikolsz-burgban
Nikon	ni-kon
Nisápur	niszáp-ur
Nith	nít
Nivelle	nivel
Nixon	nik-szon
Nizza	nidz-dza
Nizzát	nidz-dzát
No pasaran!	nopászárán
Nobel	nóbel
Nobile	nóbile
Noblie	nóbile
Noctuid	noktujid
Noel	no-el
Noel Coward	noel káoörd
Nogués	nojesz
Nomura	nom-ura
NORAD	norád
Norah	nórá
Nore	nór
Noricum	norrikum
Norma	nor-ma
Normale Superior	normál szuperior
Norman Davis	normen déjvisz
Norman Vincent Peale	normen vinszent píl
Norrie	norrí
North	norsz
North American	norsz ömeriken
North Foreland	norsz fórlend
North Miami Beach High Schoolba	norsz májámi bícs hájszkúlba
Northumbria	nortumbrija
Northwestern	norszvesztern
Nosferatu	noszferátu
Nostra	nosztra
Notionnál	nócijonnál
Notley	nótli
Noton	nótön
Notorious Jumping Frog	notóriösz dzsámping fróg
Notre Dame	notre dám
Notre-Dame	not-re dám
Nottinghamshire	nátingemsír
Nova	nóva
Nova Scotia	nóva szkósa
Novae	nóve
Novarum	novárum
Novell	návöl
Novgorod	nov-gorod
Novibazari	novi bázári
Novikov	novi-kov
Novocaint	novokaint
Noxiousról	noksziuszról
NPL	enpéel
NPR	enerpí
NSDAP	en-esz-dé-á-pé
NSZK	eneszká
Nulandot	nálöndot
Numidia	numídija
Nuorteva	nörtevá
Nuova Antologiá	nuóvá ántolodzsíjá
Nursiai	nurszijai
NUWC	en ú duplavé cé
Nyarlathotep	nyarla-totep
Nyartathotep	nyarla-totep
Nyikolaj Rerih	nyikoláj rerik
Nyikolajenko	nyikolajenkó
Nyugat-Hemisphere	nyugat hempsőr
Oaklandbe	óklendbe
Oath Keepers	ósz-kípörsz
Obama	o-bama
Obamacare	o-bamaker
Ober	óber
Oberlin	óberlin
Oberschaarführer	óbersár-fűrer
Oberschaarluhrer Mussfeld	óbersár-fűrer müszfeld
Obersturmführer	óbersturm-fűrer
Obert	óbert
Obrenovic	obrenovics
Observatory	obszőrvötri
Observer	obszerver
Ocasio-Cortez	okászió kortez
Occam	okkám
Occator	okkátor
Ocskay	ocskai
Octaviának	oktávijának
Octavianusé	oktávijánuszé
Octavianusszal	oktávijánusszal
Octaviat	oktáviját
Octaviát	oktáviját
Oculus	okulusz
ODESSA	odessza
Odesszában	odesszában
Odilo	ódiló
Odon	ódon
OECD	ó-etcédé
Offa	offá
Office	ofisz
Ofonius Tigellinus	ofónijusz tigellinusz
Ogulnia	ogulnija
Ohnfhunn	ónfún
Ohrana	orana
Ohranát	oranát
Oise	oászi
OKH	ókáhá
Oklahoma	oklahóma
Oklahoma City	oklahóma sziti
OKW	ókávé
OLAF	o-laf
Olaf Stapledon	o-laf sztépöldon
Olathoe	ulátue
Olathoét	ulátuét???
Olav Tryggvason	oláv trüggvászon
Olga Belogolova	olga beládzsolová
Olivan	oliven
Olivarez	oli-várez
Olive Streeten	olív sztríten
Oliver Cromwell	oliver-króm-vell
Oliver Cromwellt	oliver krónvellt
Olivia	olivia
Olney	ólni
Oloon Yjeet	olún üdzsít
Oltacnek	olteknek
Olympiát	olimpiját
Omaha	oma-ha
Omar Bradley	omár bredli
Omoneus	omoneusz
Onavo	onávó
Onaz	onász
Oneida Parkba	onejda park
Ontario	ontárió
Oolon Calluphid	úlon kálufid
Oolon Colluphid	úlon kálufid
Oolon Coluphid	úlon kálufid
Oonai	únaji
Ooth-Nargai	út nárgát
Ooth-Nargat	út nárgát
Opellius Macrinus	opellijusz mákrinusz
Open Graph	ópen gráf
Ophir	ofír
Opole	opol
Oppeln	ópeln
Oppenheimer	oppen-hejmer
Optimálóban	optimálóban
Optimisia	optimíszija
Optimus	optimusz
Ora et labora!	órá et lábórá
Orange Pointnál	orindzs pojintnál
Oranje	oranzs
Orban Suess	orbán zűsz
Ordnung muss sein	órdnung mussz zájn
Oregon	ore-gon
Orenda	órenda
Oreodon	ore-odon
Oreste	oreszte
Oresté	oreszté
Orestes	oresztész
Oriab	orijáb
Oriens	oriensz
Orinoco	ori-nokó
Orlando	orlandó
Orlans	órlinsz
Orne	órn
Oroszorágra	orosz-országa
Orpingtomiak	orping-torniak
Orpington	orpington
Orpmgtonra	orpingtonra
Orrin Hatch	orin hecs
Orsay	Orsze
Orseolo	orzeoló
Orsinikat	orszínikat
Orsova	orszova
Orwell	orvel
Orzel	orzel
Oscar	oszkár
Oscar Wilde	oszkár vájld
OSF	óeszeff
Osiris	ozírisz
Oslóban	oszlóban
Oslónál	oszlónál
Oslót	oszlót
Osóbka-Morawski	oszóbka morávszki
Osowiec-Twierdza	oszovjec tvye-erdzá
OSPEDALE DELLA MISERICORDIA	oszpedále dellá mizerikórdijá
Ossabaw	osszábó
Ostenburg	ósztenburg
Ostendétől	ósztendétől
Ostennek	ósztennek
Ostia	ósztija
Ostiának	ósztijának
Ostiát	ósztiját
Ostmark	ósztmárk
Ostriker	ösztríker
Oswiecimban	oszvícimban
Othello	otelló
OTP	ótépé
OTSZ	ótéesz
Ottavio	ottávió
Otto	ottó
Otto Colonnát	ottó kolonnát
Otto Hahn	ottó hán
Otto Skorzeny	ottó skorzeny
Ottonianum	ottománijum
Oughta Know	ótta nó
Ouistreham	uísztréám
Oukranos	úkránosz
Overlord	óverlord
Oversight Board	óverszájt bórd
Overstock	óversztok
Owing Mills	óving millsz
Oxford	okszford
Oxuson	okszászon
Oyster Baron	ójszter bárón
Ozone Company	ózon kámpöni
Ozora	ozo-ra
Paasikivi	pászikivi
Pablo Picasso	pábló pikásszó
Pabodi	pábodi
Pabodienek	pábodínek
PAC	píéjcí
Pace Barnes	pész bárnsz
Pacis Augustae	pátcisz auguszté
Packard	pákárd
Packardban	pákárdban
Packardját	pákárdját
Paddy Kingsiandnek	pedi kingszijendnek
Padilla	pádíjja
Padova	pad-ova
Padrone	párdóne
Padus	pádusz
Paege	pídzs
Pagaszi	págászi
Page	péjdzs
PAGEO	págeó
Paget	pedzset
Pahlavi	pálávi
Pain	péjn
Paine	pen
Paitak	pájták
Paix	peksz
Palacky	palatzki
Palatinus	plácinusz
Palazzo	páláddzó
Palazzo Vecchio	páládzó vekkijó
Palazzo Venezia	páládzzó venezijá
Palazzo Veneziában	páláddzó venezijában
Palestinian Society	pálesztínien szoszájöti
Paliscsev Borba	palicsev bor-ba
Pallas	pállász
Pallavicini Sforza	páláviccsíni szfortza
Palmettó	pálmettó
Palo	páló
Palomar	pálomár
Palos	pálosz
Paltonnle	páltónl
Pamet	pemet
Pamhez	pemhez
Pamplona	pamplóna
Pancho Villának	páncsó víjjának
Pancsa Sil	páncsá szíl
Pandzsab	pándzsáb
panem et circenses	pánem et circenzisz
Pang	páng
Pankaj Mishra	pánkáj misrá
Panmindzson	pánmin-dzson
Pannonfában	pannon-fában
Pannonia	pannónia
Pannoniába	pannónijába
Pannonián	pannóniján
Pannoniát	pannóniját
Pannonius	pannónijusz
Panormoszt	panormoszt
Pansa	pánzá
Pansel	penzel
Pantheoh	pánsző
Pantheon	pant-eón
Panther	pánter
Pantikapaion	pántikápájjon
Pantokrator	pántokátor
Panzer	pántcer
Panzerhadosztályokat	páncer hadosztályokat
Papagosz	pápágosz
Papen	pápen
Paradeiser	párádízer
Paraguay	párágváj
Parakilas	párákilász
Paranoid Android	para-noid and-roid
Parcell	párszel
Parentalia	páretálija
Parikh	parikh
Parisz	párisz
Park	párk
Parksnak	páksznak
Parlamentum Runnymeade	párlámentum runiméd
Parler	párlör
Parmageddon	parma-geddon
Parmát	pármát
Parmenión	pármenijón
Parosz	párosz
Parricida	páricída
Parscale	párszkél
Parsifal	párszifál
Parsons	párszonsz
Parsonsszal	párszonsz-szal
Parsonst	párszonszt
Parthenon	párt-enón
Parthenosz	pártenosz
Parthia	pártija
Parthosz	pártosz
Parthus	pártus
Partium	partzijum
Partners	pártnörsz
Parton Vellmore	párton vellmór
Party	párti
Pasde	páz-de
Paska	pas-ka
Paso Club	pázó klub
Passchendaelét	pesöndélt
Passierschein	pásszír-sájn
Pasta Fasta	pásztá fásztá
Pasteur	pásztőr
Paszargadai	paszargadai
Pataliputra	pátáli-pútrá
Patet	pátet
Pathfinder	pász-fájnder
Patmosz	pátmosz
Patrasz	pátrász
Patria	pátrija
Patrick	petrik
Patriotów	pário-tóv
Patriots	péjtrijotsz
Pátzay	pácaji
Pául	pól
Paul Copan	pól kopen
Paul Grewal	pól grivál
Paul Krugman	pól krúgman
Paul Ryan	pól rájön
Paula	pau-la
Paula Harper	póla hárpör
Paula Nancy Millstone Jenningsszel	póla nenszi milsztón dzseningsz-szel
Pauli	pau-li
Paulus	pau-lusz
Paulus Diaconus Langobardok	pau-lusz dijákónusz longo-bárdok
Pauszaniasz	pauszánijász
Pauszaniász	pauszánijász
Pavelic	pávelics
Pavia	pávia
Paviába	pávijába
Pavle	pávl
Pavlov	pav-lov
Pavlova	pav-lova
Paxton	pákszton
Pazmaneumot	pázmáneumot
Pazzi	pádzi
Pazzo	pádzó
PC	pétcé
Peabody	píbádi
Peachtree	pícstrí
Peak	pík
Pearl	pőrl
Pearl Harbor	pörl hárbor
Pearl Harbournál	pörl hárbörnél
Pearl Harbournél	pörl hárbörnél
Pearlcorder	pőrl-korder
Pearsall	pörszál
Peary	píri
Peaslee	pázlí
Peckman	pekk-men
Pecknek	pekknek
Pecunia non olet	pekúnijá non ólet
Pedro Canahuati	pedró kánáhóti
Pedro Lasso	pedró lásszó
Peenemünde	pénemünde
Peenemündében	pénemündében
Peiraeiust	pejrá-ejjuszt
Peiraieusz	pejrá-ejjusz
Peirse	persz
Peking	pek-ing
Pella	pellá
Pelmanism	pelmönizm
Pelopidasz	pelopidász
Peloponnészosz	peloponészosz
Pelosi	pelószi
PEMBRY	pembri
PEN	pen
Penates	penátesz
Pence	pensz
Pendar	pendár
Pendergast	pender-gászt
Penguiii Books	pengví búksz
Penn Quarterben	penn kvótörben
Pennsylvania	penszil-vánia
Pennsylvaniá	penszilvánijá
Pennsylvania Avenue	penszilvánia evönyú
Penrose	penróz
Pent	pent
Pentateuchus	pentá-teukusz
Pepto-Bismol	peptó-biszmol
Percocet	perkoszet
Percy Loraine	pörszi loréjn
Perdikkasz	perdikász
Perea	per-eá
Pereme Étteremben	per-eme étteremben
Peres	presz
Peri	peri
Périer	périjé
Perko	perkó
Péronne	pérón
Perouse	peröüz
Perseidák	perze-idák
Persephoné	perszefóné
Persius	perziusz
Perszephonénak	persze-fonénak
Pertav	pertav
Perthbe	pertbe
Pertinax	pertináksz
Pesarónál	pezárónál
Peschiera	peszkijerrá
Pesztyel	pesz-tyel
Pétain	pöten
Petar	petát
Petard	petárd
Peter	pítör
Péter Hochbichler	péter hóh-bihler
Peter Jennings	pítör dzseningsz
Peter Porter	Pítör portör
Peter Richardson	pítör ricsárdszon
Peter Thiel	pítör szíl
Peters	pítörsz
Petersfieldig	pítörszfíldig
Peterson	pítörszon
Petit Larousse	pötí lárúsz
Petrarca	petrarka
Petre	petr
Petre Bagratyioni	petre bágrácijóni
Petrie	pet-ri
Petronius	petrónijusz
Petru Aron	petru áron
Petsamo	petszámó
Petsamót	peccámót
Petsamóval	peccámóval
Petschnig	petsnig
Pevensey	pevönzi
Peyer	pejjer
Pfalzot	fálcot
Pfizer	fájzör
PFSZ	pé-eff-esz
Phaedrus	fédrusz
Phandeeyar	fándíjör
Phantom	fantom
Pharisees	fárisze-esz
Pharon	fáron
Pharosz	fárosz
Pharszalosz	fárszálosz
Pheidiasz	fejidijász
Pheidiász	fejidijász
Philadelphia	filadelfia
Philadelphosz	filádelfosz
Philip	filip
Philip Dent	filip dent
Philip Deodat	filip diódát
Philip Fernbach	filip fern-bach
Philipp Scheidemann	filip sáj-de-man
Philippi	filippi
Philipposz	filipposz
Phillip Morrison	filip morisz
Phillips	filipsz
Phillips Exeter	filipsz exötőr
Philnek	fill-nek
Philo	fílo
Philogenes	filogenész
Philokratész	filokrátész
Philon	fílon
Philopatór	filopátór
Philopator Philometor Caesar	filopátosz filometor tcézár
Philosophia Naturalis Principia Mathematica	filozófiá náturálisz printcípiá mátemátiká
Philosophical	filozofiköl
Philosophy	filozofi
Philótasz	filótász
Phipps	fippsz
Phlegethon	flegetön
Phlegon	flegon
Phliasz	fílász
Phoenixben	főnikszben
Phókisszal	fókisszal
Phókisz	fókisz
Phone-Mate	fón-méjt
Photo Address	foto ödressz
Phrünikhosz	frűnikosz
Phyllis	filisz
Phyllist	fíliszt
Physica Scripta	fizíká szkriptá
Physical Review	fiziköl rivjú
Piacenza	pijászendzá
Piast	pijászt
Piavéig	pijávéjig
Piazza	pijázzá
Picadilly Circuson	pikádíli szörkösz
Picasso	pikásszó
Piccolomini	pikolomíni
Picenumnál	picénumnál
Pichai	picsáj
Pick Szeged	pikk szeged
Pickford	pik-ford
Pickman	pikmen
Pictet	piktet
Pictor	piktor
Pieipont Langley	plejpon lengli
Pier	pír
Piercc Arrow	pírsz eró
Pierce	pírsz
Pieró	pijero
Piero Falcione	pijeró fálcsóne
Pierpont Morgan	pírpont morgen
Pierre Auger Cosmic	pijer au-ger kozmik
Pierre Curie	pijer kürí
Pierre Guzman	pijer guzmen
Pierre Laval	pijer lávál
Pierre Ramond	pijer rémond
Pierre Simon	pijer szájmon
Pierre-Joseph Proudhon	pijer-zsozef prudon
Pierre-Louis Montagny	pijer lujíz montányí
Pierson	pírszon
Pikul	píkul
Pilastrino	pilásztrínó
Pilch	pilcs
Pilcher	pilcser
Pillnitzben	pilnitzben
Pilot	pájlot
Pilsudski	pilszudszki
PIN	pin
Pinang	pináng
Pinckney Tuck	pinkni tákk
Pingpong	ping-pong
Pinochet	pinocset
Pinsky Dante	pinszki dán-te
Pinta	pintá
Pippin	pippin
Pireusz	píreusz
Piri Mehmed	piri meh-med
Pisában	pízában
Pisa-Rimini	píza rimini
Pisát	pízát
Pisától	pízától
Piscatorium	piszkátórijum
Pitagorasz	pitágórász
Pitman	pit-men
Pitt	pitt
Pitti	pitti
Pittsburgh	pitcbörg
Pius	pijusz
Piust	piuszt
Pixar Stúdiós	pikszár sztúdijósz
Pixel	pikszel
Placentia	plácentijá
Plambeck	plembekk
Planck	plankk
Plank	plankk
Plantagenet	plántádzsenet
Plassey	plász-szi
Plata	plátá
Platt	plátt
Players Club	pléjersz klub
Pleiades Zeta	plejádesz zéta
Pleiades Zéta	plejádesz zéta
Plevennel	plévennel
Pliniusnak Traianus	plínijusznak trájánusz
Plum	plúm
Plutó	plútó
Plymouth	plájmáusz
PM	péem
Pnath	pnát
Pnoth	pnót
Pnüxön	pnükszön
Podolszki	podolszki
Poetilia	potílija
Poincaré	poán-káré
Poisson-Laplace	poászon-láplász
Poitiers	poá-tyijé
Pola	pólá
Polaroid	pola-rojid
Policefax	poliszfeksz
Polignac	polignátz
Political Development	politikál divelopment
Politics Watchdog	politiksz vacsdog
Polk	pollk
Polkinghorne	polking-horn
Pollard	polárd
Pollygrino	poligrinnó
Pollyphill	polifíl
Polock	polák
Pombal	pom-bál
Pompadour	pomp-ádúr
Pompeius	pompejjusz
Pompeius Magnus	pompejjusz mágnusz
Pompeiust	pompejjuszt
Pompidout	pompádú
Pompilius	pompílijusz
Poncius	pontciusz pilát
Poniatowski	pony-tovszki
Ponsonby	pánszönbi
Ponte	pon-te
Pontius Pilate	pontciusz pilát
Pontius Pilatus	poncijusz pilátusz
Ponza	pondza
Poople	pípöl
Popilius	popíliusz
Poppaea Sabinát	poppea szabinát
Populonia	populónija
Populus Romanust	populusz románuszt
Porcellino	porcsellínó
Porco	porkó
Porfirio Díaz	porfírijó diáz
Porsenna	porszenna
Porsennának	porszen-nának
Port Darwinba	port dárvinba
Portal	portál
Portalnak	portálnak
Portland	port-lend
Portlandből	portlendből
Portlandig	portlendig
Portlandtől	portlendtől
Porto Torres	portó torresz
Portsmouth	portsz-máusz
Posent	pozent
Post	pószt
Postai Telegraph	postai telegráf
Post-Dispatch	poszt diszpecs
post-truth	poszt csrúsz
Postumus	posztumusz
Poteidaia	potjdájjá
Poteidaiába	potejrájjába
Poteidaiát	potejdájját
Potheniosz	poteniosz
Potiorek	potjorek
Potomac	potomek
Potsdam	potszdám
Potsdamba	potsz-dámba
Potsdamban	potszdámban
Potter Gerard	potter dzserárd
Potters	pottersz
Poul Anderson	pól enderszon
Pound	páund
Pour	púr
Power	páoör
Power Company	páoör kámpöni
Powers	pávörsz
Pownall	pónáll
Poznan	poznán
Pozzallo	poddzáló
PR	píár
Prada	prádá
Prága	prága
Prágát	prágát
Pragmatica	pragma-tika
Pragmatica Sanctió	pragmatika szankció
Praxibetel	prakszi-betel
Predatorokat	predátorokat
Prefectéről	perfektéről
Preliumtam	prelijumtám
Preliumtarn	prelijumtám
Premarin	prem-arin
Premysldinasztia	premiszül dinasztija
Prevert	prevert
Prévost	prévó
Price	prájsz
Price Religions	prájsz rilidzsönz
Priebke	príbke
Prien	prín
Primack	pri-mek
Primavera	primávérá
Primaverá	primávérá
Primo	prímó
Prince Edward	prinsz edvárd
Princeton	prinszton junivörziti
Princeton University	prinszton junivörziti
Princetoni	prinsztoni
Principe	prinszíp
Principia	printcípia
Priscilla	priszilla
Pritchettnek	pricsetnek
Proceedings	proszídingsz
Procter	proktör
Procula	pro-kula
Production Board	prodáksön bórd
Professor	professzor
Professzor	professzor
Project	prádzsekt
Project Rainbow	prodzsekt réjnbó
Proklamationen	proklámácijónen
Prokópiosz	prokópijosz
Prónay	prónaji
Propertiust	propercijuszt
Propülaiát	probűlájját
Propulsion Company	propálzsön kámpöni
Prose Poem	próz poem
Prospect Park	proszpekt párk
Prostatikus	prosztatikusz
Prótagorasz	protágórász
Proud Boys	práud bojsz
Provence	provensz
Providence	providensz
Proxima Centauri	prokszima kentauri
Prozac	prozák
Prozess	processz
Prsemysl Ottokár	premiszül ottokár
Prut	prút
Przemysl	premiszül
Przeworski	przsevoszki
PSR	péeszer
Psychiatry	pszihietri
Psychiatryban	pszihijötriben
Pszich	pszíh
pszicho	psziho
Pszkov	peszkov
Ptolemaiosz	ptolemájjosz
Ptolemaioszokkal	ptolemájjoszokkal
Ptolemaioszoknak	ptolemájjoszoknak
Ptolemaioszoknál	ptolemájjoszoknál
Ptolemaiszok	ptolemájjoszok
Public Affairst	páblik öfferzt
Public Library	páblik lájbröri
Publius	publijusz
Publius Quinctilius Varus	publiusz kvinktíliusz várusz
Publius Servilius Casca Longus	publiusz szervíliusz kászká longusz
Pucaritambo	pukáritámbó
Puerto	puer-tó
Pugacsov	puga-csov
Puja	puya
Pujol	puzsól
Pula	púla
Pulitzer	pulitcer
Punch	páncs
Punjabi	pundzsábi
Punt	pun-t
Punta Umbria	puntá ámbríjá
Pupin	pápen
Purdue	pördű
Purdy	pördi
Puric	púrik
Purusának	puruszának
Purvis	párvisz
Puteoli	puteóli
Püthagorasz	pütágórász
Püthia	pűtija
Python	pájton
Qarqar	kargar
QQ	kúkú
Quaestor	kvesztor
Quai	kváj
Qualactin	kvalaktin
Quantico	kvántikó
Quanticó	kvántikó
Quanticóban	kvántikóban
Quantis Alpha	kvantisz alfa
Quantum Chronodynamics	kvantum krono-dájnömiksz
Quebecbe	kübekbe
Quebecben	kübekben
Quebecből	kübekből
Quebecet	kübeket
Quebeck	kübek
Queens	qvínsz
Quenelux Saxaquinje	kveneluksz szákszákvinje
Quentulus Quazarg	kventulusz kvazár
Quercia	kvercija
Querlonde	kverlón
Quesnay	kesznai
Questor	kvesztor
Questura	kvesztúrá
Questurá	kvesztúrá
Quijote	kihóte
Quijotét	kihótét
Quinan	kvinán
Quintilius Varus	kvintílijusz várusz
Quintus Curtius Rufus	kvintusz kurc-i-usz rúfusz
Quintus Dellius	kvintusz delliusz
Quirinalis	kvirinálisz
Quirinius	kvirínijusz
Quirinus	kvirinusz
Quirites	kviritesz
Quordepleen	kvordeplín
Raab	ráb
Rabaul	röbáöl
Rabutin	rabutyin
Raccordo	rákkordó
Raccordó	rákkordó
Rachel Whetstone	réjcsöl vetsztón
Ráchelként	ráhelként
Rácországot	rátcországot
Radetzky	rádetzki
Radio	réjdiő
Radomba	rádomba
Radu Serban	radu szerbán
Raeder	réder
Raetia	ráecijá
Raffaello	ráffáelló
Rahm	rám
Raiffeisen	rájfájzen
Raimondo Montecuccoli	rájmondó montekukkoli
Rajagrha	rádzságrá
Rakhine	rákín
Ralph	rálf
Ralph Alpher	rálf álfer
Raman Sundrum	rámán szundrum
Ramanujan	rámá-nuján
Rambo	rambó
Rambouillett	rambuje
Ramcharger	rámcsárdzser
Ramillies	rámilijé
Ramond	rémond
Ramsden	rámszden
Ramsgate	rámszgéjt
Rand	ránd
Randall	rendel
Randolph	rendolf
Randytől	renditől
Rangunban	rángúnban
Rapala	rápálá
Rapalát	rápálát
Raritan	ráritán
Rars 	rársz
Rasch	rásh
Rashad Robinson	ráshár robinzon
Rasíd	rásíd
Raspail	rászpáj
Rassay	rassaji
Rassenforschung	rásszenforsung
Rathenau	ráte-nau
Ratio Educationis	ráció edukációnisz
Raui Alfa	rauji alfa
Rauscher	ros-er
Ravaillac	rávejják
Raylight	réjlájt
Raymon	rájmon
Raymond Poincaré	rájmond poánkáré
RBS	árbíesz
Reader Bullard	rídör bulárd
Readingben	rídingben
Reagan	régen
Real Jesus Please Stand Up	ríl dzsízösz plíz sztend ápp
Reapereket	rípereket
Reba	re-ba
Recep Tayyip	retcep tádzsip
Recode	rikód
Recoleta	rekolétá
Record	rekórd
Redarator	redárátor
Reduction Company	ridáksön kámpöni
Reeboks	ríboksz
Rees	ríz
Réforme	réform
Regensburg	régensz-burg
Regensburgban	régensz-burgban
Régenshercegnek	régens-hercegnek
Régime	rézsím
Regina	reg-ina
Regino Évkönyve	redzsinó évkönyve
Regulus	regulusz
Rehabilitation	rehabilitéjsön
Reich	rejh
Reichenau	rejhenau
Reichnak	rejhnek
Reichsbanktól	rejsz-bánktól
Reichsrat	rejsz-rát
Reichstag	rejsz-tág
Reichswehr	rejsz-ver
Reichswehrről Wehrmachtra	rejszverről ver-máktra
Reichswer	rejsz-ver
Reichswert	rejszvert
Reid	réjd
Reikerben	rejkörben
Reims	rejmsz
Reinhard Heydrich	rejn-hárt hájdrikh
Reisgau	rájzgau
Rekkared	rekkáred
Relations	riléjsönz
Religion	rilidzsön
Remington	reming-ton
Remus	rémusz
Renata Kallosh	renátá kálosh
Reniger	reny-ijé
renovatio imperii	renovácijó imperí
Republic	ripáblik
Requiem	rekvijem
Rerum	rérum
Research	ríszörcs
Research Agency	ríszörcs édzsönszi
Research Establishment	riszörcs isztáblishment
Résistance	rézisz-tansz
Resolutióban	rezolúcióban
Resolution	rezolúsön
Rethel	rétel
Retro	retró
Reusable Lunch	rijúzöböl láncs
Reuter	rójter
Reuters Next	rajtersz nekszt
Révay	rávai
Revievv	rivjú
Review	rivjú
Rewiev	rivjú
Rex Anglorum	reksz anglórum
rex francorum	reksz fránkórum
Rex Italiae	reksz itálije
Reynaud	réjnó
Reynolds	réjnoldsz
Reza	re-za
RF	eref
RH	erhá
Rheem	rím
Rhiis Bhuurosh	rísz brúros
Rhodésia	rodézia
Rhodesiát	rodéziát
Rhodiosz	rodijosz
Rhodosz	rodosz
Rhone	rón
Rhoxané	rokszáné
Ribat	ribát
Ribbentrophoz	ribben-tropphoz
Ribonu-Clegg	ribonu-klegg
Rica	ríka
Ricardo Klement	rikárdó kle-ment
Riccardo Klement	rikárdó kle-ment
Ricci	riccsi
Rice	rájsz
Richard	ricsárd
Richárd	ricsárd
Richard Acland	ricsárd eklend
Richard Bentley	ricsárd bentli
Richard Blumenthallal	ricsárd blúmentállal
Richard Chancellor	ricsárd csenszölor
Richard Dawkins	ricsárd dókinsz
Richard Feynman	ricsárd fejnman
Richard Klement	ricsárd kle-ment
Richard Pickman	ricsárd pikmen
Richard Upton Pickman	ricsárd ápton pikmen
Richard Wagner	rihárd vágner
Richardot	ricsárdot
Richelieu	riselijő
Richer	ri-cser
Richmond	ricsmond
Richter	richter
Rickmansworthban	rikmesz-vörszben
Rico	ríkó
Riedel	rídel
Riehmond	ricsmond
Ríley Andersen	rájli enderszen
Rinaldo	rináldó
Rinaldó	rináldó
Rinso	rinzó
Rintelen	rintelen
Rio de Janeiró	rijó de zsánejró
Ritter	rit-ter
Ritz-Carltonban	ritc kárltonban
Rivera	rivéra
Rizgar	rizgár
Robart	robárt
Robert	robert
Robert Clive	robert klív
Robert Devereux	robert derevő
Robert Dicke	robert dikk
Robert Mercer	robert mörször
Robert Mueller	robert müller
Robert Reich	robert rájkh
Robert Vansittart	robert vánszittárt
Robert Walpole	robert velpól
Roberta Brawer	roberta bauer
Roberto Bellarmino	robertó belármínó
Robespierre	robeszpijer
Robespierre-Marat	robeszpijer-márát
Rocca	rokka
Roche	rósh
Rochelle	rosell
Roche-Vielsalm	rosh vjelszám
Rockefeller Center	rokefeller szentör
Rocky Mountainsban	roki máuntinszban
Roden	ro-den
Rodney	rodni
Rodosz	rodosz
Ródosz	rodosz
Rodrigo Duterte	rodrigó duterte
Roenne	rőn
Roger	ro-dzser
Roger Bushell	ro-dzser bushel
Roger Dumont	ro-dzser dümón
Roger Keyes	rodzs-er kéjnsz
Roger Mortimer	ro-dzser mort-imer
Roger Penrose	rodzser penróz
Roger Scholl	rodzser sholl
Rogerius	rodzserijusz
Roggendorf	rógen-dorf
Rogner	rágnör
Rohm	róm
Röhm	rőm
Röhmékkel	rőmékkel
Röhmöt	rőmöt
Rokolból	?? Pokolból
Róle	ról
Rolex Super	roleksz szuper
Rolf Landauer	rolf land-auer
Rolland	roland
Rolls-Royce	rolsz rojsz
Roma	róma
Romain Rolland	romen rol-an
Romam	rómám
Roman Law	romen ló
Roman Society	romen szoszájöti
Romana	románá
Romanát Britannia	románát britannika
Romani	románi
Romanov	roma-nov
Romanum	románum
Romanus	románusz
Romeót	rómeót
Romer	rómer
Rominá	rom-iná
Rommel	rom-mel
Romnod	romnó
Romulus	romulsz
Romulust	romuluszt
Rónáid Reagan	ronáld régen
Ronald Reagan	ronáld régen
Ronnie Knoxot	roni noksz
Roose	rúszi
Roosevehhez Írott	rózvelthez írott
Roosevelt Franklin Delano	rózvelt frenklin delánó
Roosta	rúszta
Roostát	rúsztát
Root	rút
Roper	ropör
Ropes	rópsz
Rorschach	ror-sach
Rosa	róza
Rosa Parks	rósza párksz
Roscoe	roszkó
Rose	róz
ROSEBUD	rózbád
Rosen	rózen
Rosenberg	rózen-berg
Rosencranz	rózen-kránc
Rosensweig	rózenvájg
Rosent	rózent
Rosnernek	rosznernek
Ross	rossz
Rossellino	rossze-línó
Rossini	rosszíni
Rosslynban	rosszlinban
Rost	roszt
Rosythba	roszitba
Rothari	rotári
Rothermere	roter-mer
Rothman	rótman
Rőtszakállra	rőtsza-kállra
Rottenführer	róten-fűrer
Rotterdam	rotter-dám
Rotterdami Erasmus	rotter-dámi erászmusz
Rougier	ruzsijé
Rousseau	russzó
Route	rút
Rowland	rólánd
Rowls	rólz
Royal Astronomical Society	rojöl asztronomiköl szoszájöti
Royal Bank	rójöl benk
Royal Institution	rojöl insztitúsön
Rubicon	rubikon
Rubicót	rubikót
Ruchi Sanghvi	rúcsi szángvi
Rückkehr	rükk-éhr
Rücksprache	rükk-spráhe
Rudi Mandl	rudi mendöl
Rudnam	rudnám
Rudolf Clausius	rudolf klauziusz
Rudolf Hilferding	rudolf hilferding
Rudolf Höss	rud-olf hössz
Rudy Giuliani	rudi dzsulijáni
Rudyard Kipling	rádzsörd kipling
Ruggero Perugini	rudzseró perudzsíni
Ruhr	rúr
Runciman	ránszimen
Runstedt	rund-stett
Rusd	rúsd
Russcllnek	rásszelnek
Russel	rásszöl
Russell	rásszel
Russell Hulse	rásszel hálsz
Ruth Martin	rút mártin
Ruther Burbank	rúter börbenk
Rutherford Aplleton	rádörford öpplítön
Ruveiszat	ruvejszát
RX	eriksz
Ryan	rájen
Rybovich	ribovics
Rydz-Smigli	ridz szmígli
SA	esszá
Saab	száb
Saar	szár
Saarbrücken	szárbrükken
Saarlauternnél	szárlauternnél
Saarlouis	szárlujísz
Sabahban	szábáhban
Sacha Baron Cohen	száshá báron kóen
Sachsenhausen	szákszen-hauzen
Sacra	szákrá
sacra corona regni	szákrá koroná regni
Sacramento	szákrá-mentó
Sacramentó	szákrá-mentó
Sacrum Palatium	szákrum plácijum
Sadducees	száddutse-esz
Sadowa	szadova
Saducismus Triumphatusának	száducizmusz triumfátuszának
Safari Arms	száfári ármsz
Safeway	széfvéj
Sagittarius	szágitáriusz
Sagresban	szágreszban
Saguntum	száguntum
Said	szájid
Saigon	szájgon
Saint Denis	szent denisz
Saint-Antoine	szen-ántoán
Saint-Cloude	szen-klód
Saint-Germain	szen-zsörmen
Saint-Just	szen-zsüszt
Saint-Valéry	szen váleri
Saipan	szájpán
Sajó	sajó
Sajtinak	sajt-inak
Sakita	szákitá
Salamon	szálámon
Saldarini	száldáríni
Salef	szálef
Salem	szálem
Salesforce	szélszforsz
Salisbury	szálsz-börri
Sallustius	szállusztijusz
Salm	szálm
Salom Nagar	sáltom nágár
Salt Lake Cityben	szált léjk sziti
Salvador	szálvádor
Salvador Dali	szálvádor dáli
Salvadornak	szálvádornak
Salvius Othót	szálvijusz ottót
Salza	szálzá
Salzburg	záltz-burg
Salzburgnál	zálcburgnál
Salzburgot	záltz-burgot
Samas	számász
Samidh Chakrabarti	számid csakrabati
Samnél	szemnél
Samo	számó
Samoán	szamoán
Samriában	szamrijában
Samriát	szamriját
Samsung	szamszung
Samu	sa-mu
Samuel Braunstein	szemjuöl braun-sztín
Samuel Hoare	szemju-el hoáre
Samuel Huntington	szemju-el hántington
San Diego	szándijégó
San Diegóba	szándijégóba
San Francisc	szán fránsziszk
San Francisco	szán fránsziszkó
San Franciscó	szánfránsziszkó
Sancta Clara	szánktá klárá
Sanctam	szánktám
Sancti	szánkti
Sanctio	szanktzió
Sanctiónak	szankciónak
Sanctiót	szankciót
Sandage	szendridzs
Sandberg	szendberg
Sanders	szendörsz
Sandford	szenford
Sandomierztől	szándomírztől
Sandra Faber	szándrá fáber
Sandro Botticelli	szándró boticselli
Sanduleak	szanduleák
Sandy Hook	szendi húk
Sandy Parakilas	szendi párákilász
Sanghajban	sháng-hájban
Sanghajt	sáng-hájt
Sanghvi	szángvi
Sang-Jindinasztiát	sáng-jung dinasztiját
Sangok	sangok
Sanjurjo	szánhurhó
Sankara	szankara
Sankt Gallen	szánkt gállen
Sanlúcar	szánlúkár
Sansu	szánszu
Santa	szántá
Santa Croce	szántá krócse
Santa Crocé	szántá krócsé
Santa Maria Novella	szántá máríjá novellá
Santa Maria Novellá	szántá máríjá novellá
Santa Monica	szántá mónika
Santa Reparata	szántá repárátá
Santa Trinitá	szántá trinitá
Santagrinus	szántágrínusz
Santagrius	szántágrijusz
Santiago	szántijágó
Santo Spirito	szántó szpiritó
Santo Spiritó	szántó szpiritó
Santraginus	szántrágínusz
Santung	szántung
Santungot	szántungot
Sanvalvwag	szánválvág
Sanyiki	shanyiki
Sao Pauló	szao paoló
Sapiens	szápijensz
Saquo-Pilia Henshán	szákkuó pílija hensán
Sara Lippincot	szárá lipinkot
Sarah	szárá
Sarah Bernhardt	szárá bernárt
Sarai Aharoninak	szárá áhároninak
Saratoga	szaratóga
Sark	szárk
Sárkány Burger Bárok	sárkány bur-ger bárok
Sarnath	szárnát
Sarnathra	szárnátrá
Sarraut	száró
Sarritor	szarritor
Sarrukín	szattukin
SARS	szársz
Satre	szátrö
Saturday Night Live	szátördéj nájt lájv
Saturnalia	szaturnálija
Saturni	szaturni
Saturnia	szaturnia
Saturnus	szaturnusz
Satyricon	szátürikón
Saul Perimutter	szól peri-mutter
Saulson	szólszon
Sauzin	szau-zin
Sava Kosanovich	szává koshánovics
Saverin	száverin
Savoi	szavoj
Savonarola	szavonaróla
Savonarolá	szavonarólá
Savoya	szavoja
Savoyá	szavojá
Savoyáért	Szavojáért
Saxaquine	szákszákín
Sayville	szájvill
Sbardellati	szbárdelátti
Scaevola	szkájevola
Scala	szkála
Scapa	szkápá
Scapa Flow	szkápá fló
Scapában	szkápában
Scapára	szkápára
Scapát	szkápát
Scaramia	szkárámijá
Scarlatti	szkárlátti
Scavino	szkávínó
Scharfenberg	sárfenberg
Scharnhorst	sárnhórszt
Schatz	shátc
Scheer	sér
Scheidemann	sáj-de-man
Scheiring	shájring
Schelde	selde
Scheldéig	seldéig
Schellenberg	sellen-berg
Scheppele	sheppel
Scherbius	ser-biusz
Scherk	shrek
Schick Brithaus	sikk brit-hausz
Schiff	shliff
Schiller	shil-ler
Schissler	shiszler
Schleicher	slájher
Schleswiget	shlesz-viget
Schleswig-Holsteinban	slezvig hols-tejnben
Schlick	shlikk
Schlieffen	slífen
Schliemann	slí-man
Schmalkaldenben	shmal-kaldenben
Schmarkle	smárköl
Schmerling	shmerling
Schmid	shmitt
Schmidt	shmitt
Schneckloth	sneklosz
Schnorchel	snorhel
Schrage	shréjdzs
Schreibmax	srájb-maksz
Schroepfer	srőpfer
Schuhmann	súman
Schulenburg	súlen-burg
Schulenburgnak Berlin	súlen-burgnak berlin
Schulenburgnál	súlenburgnál
Schumachcrek	súmáherek
Schuman	súman
Schumann	shú-man
Schumer	shrúmer
Schumpeter	shum-peter
Schuschnigg	sus-nig
Schutzhaft	succsáft
Schwarz	shvartc
Schwarzenberg	shvártzn-berg
Schwarzschild	shvartc-shíld
Schwechatnál	shvehát
Schweinhund	svájn-hund
Schwendi	shvendi
Science	szájensz
Sciences	szájensziz
sci-fi	szifi
Scipio	sztcípijó
Scipiók	sztcípijók
Scobie	szköübi
Scolari	szkólári
Scoresby	szkórszbi
Scorza	szkorcá
Scotland Yard	szkotland jard
Scott	szkot
Scott Russell	szkott rásszel
Scriptor	szkriptor
SD	eszdé
Sean	sén
Sean Parker	shén párkör
Seánnak	szeánnak
Search Team	szörcs tím
Sears Best	sírsz beszt
SEATO	szeátó
Seattle	szíjetöl
Sebag Montefiore	szebágh monte-fjóre
Sebastian	szebásztián
Secession	szeszessön
Secolo	szekkoló
Secor	szekor
Security Agency	szekjuriti édzsönszi
Sedan	szedán
Sedelmeier	zédel-meyer
Seeckt	sekt
Seetharaman	szíthármán
Segall	szegál
Segovia	szegóvija
Seherezádé	sehere-zádé
Seianust	szejjánuszt
Seitz	zájtc
Seizo Arisue	szejizó áriszu-e
Sektionnak	szekcijónnak
Selarn	szelárn
Selmán Waksman	szelmán vákszman
Selvan	szelván
Semmelweis	szemmelvejsz
Semper	szemper
Sempronius	szemprónijusz
Sempronius Gracchus	szemprónijusz gráhhusz
Seneca	szeneka
Senecát	szenekát
Seng	szeng
Sennyei	seny-nyei
Septimius Severus	szeptimusz szeverusz
Septuaginta	szeptuaginta
Sera	szerá
Será	szerá
Seranniáig	szeránijáig
Serannian	szerániján
Seraph	szeráf
Sergant	szördzsönt
Sergey Brin	szergej brin
Serie	szerí
Seriff	serif
Serrano Sunernek	szerránó szúnernek
Sertorius	szertórijusz
Sertoriusszal	szertórijusszal
Servco Supreme	szervkó szuprím
Servcónak	szervkó
Servetónak	szervetónak
Services	szörvisziz
Servilia Caepionis	szervília káe-pijónisz
Servius Sulpicius Galba	szervijusz szulpicijusz gálbá
Servius Tullius	szervijusz tullijusz
Sesefras Magna	szeszefrász mag-na
Sesefron	szeszefron
Sesefros Magna	szeszefrosz mag-na
Sesonk	szeszonk
Settlement	szetölment
Setyko	setykó
Severus	szeverusz
Sevillába	szevíjjába
Sevillát	szevíjját
Sevirjov	szevirjov
Sevorbenpstry	szevorbenpsztri
Sevorbeupstry	szevorbenpsztri
Sewanee	szivené
Sextiusféle	szeksztcijusz-féle
Sextus	szeksztusz
Sexus	szekszusz
Seychelle	szeshell
Seyss-Inquart	szejsz inkvárt
Sforzák	szfortzák
Shackleton	sekölton
Shaddad	sád-dád
Shakabao	sákábáó
Shakespeare	sékszpír
Shakespeare Cymbeline	sékszpír szimbölín
Shane	shéjn
Shang	sáng
Shangri	sángri
Shank	sánk
Sharp	sárp
Shavitnak	sávitnak
Sheehan	shíhán
Sheergawz	sérgóc
Sheerness	sérnessz
Sheldon Glashow	sheldon gláshó
Shelton	selton
Shenandoah	senendó
Sheraton Park	seráton park
Sherlock Holmes	serlok holmsz
Sherman	sörmen
Sherrin	serrin
Sherwood	servúd
Sheryl	sheril
Shiloh	siló
Shimon Gibson	shi-mon gibzon
Shinwell	sinvel
Ship Streeten	síp sztríten
Shirley	sőrli
Shoshana Zuboff	shosháná zúbov
Show	só
Shulman	súl-man
Shultze-Delitzsch	shultz delits
Siauliai	Szjaulijaui
Siauliau	Szjaulijau
Sibylla	szibilla
Sibyllát	szibüllát
Sicilia	szcília
Sidley Austin	szidni ósztin
Sidonia	szidónia
Siebel	zíbel
Siegbert	zígbert
Siegbert Heister	zígbert hájszter
Siegfried	szíkfríd
Siegfriedvonal	szígfríd vonal
Siemens	szímensz
Siemens-Martin	szímensz mártin
Sierra Leonéba	szijerra leónéba
Sierra Leonéból	szijerra leónéból
Siger	zíger
Sigismund	szigiszmund
Sigmond	zigmund
Sigmund Freud	zígmund frajd
Sigmund Freudnak	zigmund frajd
Signor	szinyór 
Signora	szinyórá
Signore	szinyóre
Signoria	szinyórija
Signoriá	szinyórijá
Signorina	szinyoríná
Sigurd	szigörd
Sikorski	szikorszki
Silah	sziláh
Silicon Slopes Tech Summiton	szilikon szlópsz tícs számiton
Silva	szilva
Silvá	szilvá
Silvanus	szilvánusz
Silverman	szilvörmen
Silviát	szilviját
Silvius	szilvijusz
SIM	szim
Simai	szimai
Simba	szimba
Simbával	szimbával
Simmonst	szimonszt
Simón Bolívar	szimón bolivár
Simonnak	shi-mon-nak
Simonoff	szájmo-nov
Simor	shi-mor
Simovic	simovics
SIMPLE	szimpöl
Simplicity	szimplisziti
Simpson	szimszon
Sinai	sínaji
Sinarába	szinarába
Sinclair	szinkler
Sindely	szindli
Sinderella	szinderellá
Sindhunak	szindunak
sine ira et studio	színe írá et sztúdijó
Singer	szingör
Sinn Fein	szinn fejn
Sinnustrán	szinnusztrán
Sinopnál	szinopnál
Sion	shi-on
Sipka	sipka
Sipper	szipper
Siracusát	szirakúzát
Siráz	sziráz
Sisatovac	shishatovács
Siscia	szisztcija
Sisuit	sziszvít
Sitt Thway Aung	szitt tváj óng
Sitter	szit-tör
Sitzkrieg	zicc-kríg
Siva	síva
Siva Vaidhyanathan	shíva vájdjá-nátán
Sivát	sívát
Sixtus	sziksztusz
Sixtusi	sziksztuszi
Skagerrakon	szkágerákón
Skaggerakból	szkágerákból
Skai	szkáj
Skerki	szkerki
Skibbereenben	szikörínben
Skip	szkip
Sklodowska	szkodovszka
Skóciában	skóci-ában
Skocpol	szkokpol
Skye	szkáj
Skymaster	szkájmásztör
Slaby	szléjbi
SLAC	szlek
Slammeréktől	slámmer-éktől
Slessor	szlesszor
Sligo	szlígó
Sloan	szlón
Slockfish	sztokfis
Sloman	szlóman
Sloof	szlúf
Smarr	szmárr
Smetona	szmetona
Smiley	szmájli
Smiljan	szmílján
Smith	szmisz
Smith Croydonból	szmisz krojdonból
Smithfieldnél	szmiszfíldnél
Smithonian Astrophysical Observatoryba	szmisz-szonien asztrofiziköl obszörvötribe
Smithonian Center	szmisz-szonien szenter
Smithsonian	szmisszonijen
SMS	esemes
Snapchat	sznep-cset
Snasu	sznászu
Sneed	szníd
SNL	eszenel
Sobieski	szobijeszki
Sobralba	szobrálba
Social Resposibility	szósöl riszponzibiliti
Societas Jesu	szoszijetász yezu
Society Foundations	szoszájöti fáundéjsön
Socorro Operations Centerbe	szokkoró oreréjshönz szenterbe
Sogliato	szojjátó
Soho	szohó
Sohó	szohó
Soklyósy	sokjósi
Solar	szolör
Soldner	szoldner
Solent	szolent
Solferino	szolferínó
Solingenben	szólingenben
Solliccianó	szoliccsánó
Sollum	szollám
Soltaut	szoltaut
Solymost	sojmosht
Someone Like You	számván lájk jú
Somersetben	számörszetben
Somsich	szomis
Somssich	som-sics
Sona	szoná
Sona-Nylt	szoná nült
Sonder	zonder
Sonderkommendo	zonder-kommandó
Sonderkommendó	zonder-kommandó
Song	szong
Sonny Metha	száni meta
Sonora	szonórá
Sony	szoni
Sophie	szofí
Sorbon	szorbon
Sorbonne	szorbon
Sorel	szorel
Sorge	zorge
Sosigenes	szoszigenész
Sotelónak	szotelónak
Souhanis	szólijánisz
Soulianis	szólijánisz
Sources	szorsziz
South	száusz
South Park Commonsban	száusz párk komonszban
Southamptonben	száuszhemptönben
Southeastern Bell	száusz-ísztörn bell
Southern	száuszörn
Southland Mellből	száuszlend mellből
Southwestern	száuszvesztern
Sovereign	szuveréjn
Spaatz	szpátc
Space	szpéjsz
Space Studies	szpéjsz sztádíz
Spalato	szpálátó
Spalatóba	szpálátóba
Spanyol	spanyol
Spanyolország	spanyol-ország
Sparapani	szpárápáni
Sparkassen	szpárkásszen
Sparks	szpárksz
Spartacus	szpártákusz
SPD	esz-pé-dé
Spear	szpír
Spears	szpírsz
Special Troopshoz	szpesöl trúpszhoz
Speckle	szpekl
Specnaz	szpetcnáz
Spee	szpré
Speer	spér
Spencer	szpenszer
Spengler	speng-ler
Spergel	szpergel
Sperlinget	szpörlinget
Speyer	spejjer
Speyerben	szpejerben
Sphakteira	szfáktejra
Sphinx	szfinksz
Spica	szpíka
Spice	szpájsz
Spiegelben	spígelben
Spiegelnek	spígelnek
Spina	szpíná
Spinalé Trunco	szpinálé tránkó
Spinalé Truncót	szpinálé tránkót
Spiner	szpinör
Spinne	szpíne
Spinoza	shpi-nóza
Spiritusfabriks	spiritusz fábriksz
Spitfire	szpitfájör
Spitzbergákon	spic-bergákon
SPLIT CITY	szplit sziti
Spokaneben	szpókéjnben
Spot	szpot
Spree	szpré-j
Sprembergbe	szprem-bergbe
Springfield	szpringfíld
Springs	szpringsz
Spruance	szprúönsz
Spurgen	szpörgen
Spurinna	szpurinna
Spurius Cassius	szpúrijusz tcézár
Spydercó	szpájderkó
Spyderco Civilian	szpájderkó szivilijen
squadro	szkvádró
Squolnshellus Zétán	szkvorn-sellusz zétán
Squomshellus	szkvorn-sellusz
Squornrhellusi Mocsárnyelv	szkvorn-selluszi mocsárnyelv
Squornshelloiis Delta	szkvorn-sellojisz delta
Squornshellous Bétán	szkvorn-sellojisz béta
Squornshellus	szkvorn-sellusz
Srebrenica	szrebrenyica
Srinivasa Ramanujan	szrinivászá rámánuján
SS	eszesz
SSC	eszeszszí
St. Louis	szenlujisz
Stackmaiur	szták-májőr
Stadtluft macht frei	státtluft máht fráj
Staff	szteff
Stafford	szte-ford
Stafford Cripps	sztefford kripsz
Staffordtól	szteffordtól
Stagg Field	sztágg fíld
Stagyar	sztágjár
Stalag Luft	stalag luft
Stammer	sztám-mer
Stamos	sztámosz
Stan	szten
Standard	sztenderd
Standley	sztendli
Stanford	sztenford
Stanford White	sztenford vájt
Stanislaw Ulam	sztániszláv ulem
Stanley	sztenli
Stanmore	sztenmór
Stanzákat	sztancákat
Star Line	sztár lájn
Star Trek	sztár trekk
Starbucks	sztárbáksz
Starckmann	sztrek-men
Starhemberg	sztárem-berg
Stark	sztárk
Starkweather	sztárkvedör
Starkweather-Moore	sztárkvedör múr
Starling	sztárling
Star-Spangled Banner	sztár szpregöld bennör
Startron	sztárton
startup	sztártáp
State	széjt
State Street Mallen	sztéjt sztrít málön
Statesman	sztéjtszmen
Stavisky	sztáviszki
Stavro	sztávró
Stavromula	sztávromúla
Stavrót	sztávrót
Steal	szíl
Steel Company	sztíl kámpöni
Stefan Razvan	sztefán rászván
Stefánia	shtefánia
Stefanie Komossa	sztefáni kámossza
Stefanó	sztefánó
Stegbartle	sztegbártöl
Steinberg	stejn-berg
Steindl	shtejdl
Steinhardt	shtejn-hárt
Steinmetz	stejn-mec
Steinville	shtejn-vill
Stella	sztellá
Stephanus	sztefánusz
STEPHANUS REX	sztefánusz reksz
Stephen	sztefen
Stephen Crane	sztefen krén
Stephen Fulling	szteven fulling
Stephen Grover Cleveland	sztefen gróver klívlend
Stephen Hawking	sztívön hóking
Stephen Langtont	sztivön lengtont
Stephen Rubin	sztefen rubin
Stephenson	sztívönszon
Sterling	sztörling
Stethelost	sztetloszt
Stettin	stettin
Stettiniusnak	sztettiniusznak
Steuben	shtójben
Steve Bannon	sztív benön
Steve Jobs	szív dzsobsz
Steven Spielberg	sztívün szpílberg
Stevenson	sztívönzon
Stevie Wonder	sztívi vándör
Stewart	sztyúárt
Steyer	sztejer
Stibor	shtibor
Stieröchsel	stír-ösel
Stilicho	sztílikó
Stimson	sztimszon
Stin	szín
Stinnes	sztájnsz
Stirlingek	sztörlingek
Stith Thompson	sztisz tomzon
Stockfish	sztokfish
Stockum	sztokkum
Stojadinovic	sztojádinovics
Stoker	sztoker
Stolo	szóló
Stonbridge	sztónbridzs
Stone	sztón
Stone Slone	sztón szlón
Stonebridge	sztónbridzs
Stonehenge	sztónhendzs
Stonehinge Villák	sztónhindzs villák
Stony Brook	sztoni brúk
Stop	sztop
Storch	sztórcs
Store	sztór
Stork	sztork
Storno	sztornó
Strabag	shtrabag
Strabo	sztrábó
Strafford	sztráf-fórd
Strahurai	shtra-hurai
Strang	sztreng
Stranraerból	sztranrarből
Strasbourg-Metz	strasz-búrg metc
Strassenfressen	sztrásszen-fresszen
Strassert	strász-szert
Strattmann	shtrátt-mán
Street	sztrít
Streetre	sztrítre
Stresa	stresszá
Stresában	sztreszában
stresai front	streszaji frónt
Stresemann	stressze-man
Stretch	sztecs
Striker	sztrájkör
Strinder	sztrinder
Stringfellow	sztringfeló
Striterax Titán Páncélördögei	sztriteráksz titán páncélördögei
Striteraxon	sztriterákszon
Stroessner	strösszner
Strominger	sztominger
Stronti	sztronti
Struensee	sztrűenzé
Strycker	sztrájkör
Stryk Lycomdan Tsing	sztrük lükomdán csing
STSI	esztíesz-í
Stuart	sztúárt
Stuart Krichevsky	sztyúárt kirshevszki
Stuart Mill	sztyúárt mill
Studebaker	sztádöbékör
Studiolo	sztudijóló
Studioló	sztudijóló
Studying	sztádiing
Stülpnagel	stűlp-nágel
Stumpf	shtumf
Stürgkh	stürgk
Sturmrnan	stúrman
Suarezben	szuárezben
Subasic	szubasics
Subasiccsal	szubasiccsal
Subasicot	szubasicsot
Subasicra	szubasicsra
Subud	szábád
Suchman	zuh-man
Suchy	szuhhe
Sucre	szukré
Suddhódana	szuddódáná
Suetoniusnál	szvetóniusznál
Suetoniust	szvetóniuszt
Suffolk County Land Company	száfolk káuntri lánd kámpöni
Suger	szüzser
Suicide	suicide
Sujszkij	szújszkíj
Sukarno	szukárnó
Sulchán Áruchot	zulhán áruhot
Sulginak	szulginak
Sulijoo	szulidzsú
Sulla	szulla
Sullának	szullának
Sullára	szullára
Sullát	szullát
Sullával	szullával
Sullivan	száliven
Sully	száli
Sumer	sumér
Summa	szummá
Summers	számörsz
Sumner Wellesnek	számnör velsznek
Sumner Wellest	számnör velsznek
Sund	Zund
Sundance	szándensz
Sundar Pichai	szándör picsáj
Sundon	szundon
Suner	szuner
Super	szupör
Superbus	szuperbusz
Superconducting Supercollider	szuperkondákting szuperkolájder
Superga	szupergá
Superioré	szuperioré
Superiornak	szuperiornak
Supernaturalist	szupernaturaliszt
Supernova	szupernóva
Suppiluliuma	szuppilúlijuma
Surtur	szörtör
Survey	szörvéj
Susan	szúzön
Susan Beneschsel	szúzön benesh-shel
Susan Desmond-Hellmann	szúzön dezmond hellmen
Susquehanna	szászkveháná
Sussex	szászeksz
Sussexet	szászekszet
Sutler	szátlör
Suvich	szuvics
Suzuki	szuzuki
Svante Arrhenius	szvent áreniusz
Svedagon	szvedágon
Svedberg	szved-berg
Sviár	szvijár
Swami Vivekananda	svámi vivekanada
Swarthmore College	szvártmór kálidzs
Sweezy	szvízi
Swettenham	szvettenhám
Swianiewicz	szvijányevitc
Swieten	shvíten
Swift-Tuttle	szvift tátöl
Swinemünde	svájne-münde
Swinemündétől	svájnemündétől
Swisher	szvisher
Swordfish	szvórdfis
Swullingról	szvállingról
SXT	esikszté
Sycophantasia 	szikofantázija
Sydney Pollack	szidni polák
Sygarius	szügárijusz
Sykes-Picot	szájksz píkő
Symphonia	simfónia
Syracuse Herald	szirákjúz heröld
Syria	szírija
Syrovy	sziroví
Systrom	szisztöm
Szamuely Tibor	szamueli tibor
Szanhedrin	szán-hedrin
Szanyko	szankó
Szapphó	szaffó
Szarajevóban	szaraj-evóban
Szasa	szása
Szasá	szásá
SZDP	esz-dé-pé
SZDSZ	eszdéesz
Széchy	szécsi
Szeder	sze-der
Szefforisz	szeffo-risz
Szép Helené	szép heléna
Szergej Krasznyikov	szergej krasznikov
Szerjozsa	szerjózsa
Szerjozsá	szerjózsá
Szídi-Rezegh	szídi rezeg
Szídi-Szulajman	szídi szulejmán
Szie	szije
Szity	szity
SZKP	eszkápé
SZKT	esz-ká-té
Szlartibartfaszt	szlartibártfászt
Szluckij	szlutc-kíj
Szonya	szonnya
Szophoklész	szofoklész
SZSZK	eszeszká
SZSZKSZ	eszeszkáesz
SZT	eszté
Sztageiroszban	szágejroszban
Sztoa Poikilé	sztoa pojkilé
Sztójay	szójai
Szüénében	szüé-nében
Szuzdalig	szuzdálig
Szvjatoszlav	szvjátoszláv
Szvjatoszláv	szvjátoszláv
Taaffe	táffe
Taaffét	táffét
Tabgha	tab-gha
Tabor	tábor
Tadeus	tádeusz
Tadeus Kosciuszko	tádeusz kosz-ciusz-kó
Tadeusz Romer	tádeusz rómmer
Tageblatt	tágeblátt
Taglalat	taglalat
Tagliozzónál	táglijoddzó
Taksasila	takszaszila
Taksony	taksony
Talasz	tálász
Tallinn	tal-lin
Tallinnba	tal-linba
Tallóciak	talócijak
Talmud	tal-mud
TAMA	tama
Tamara	tam-ara
Tamash	támás
Tamnek	temnek
Tanaka	tan-aka
Tanaria	tánárijá
Tang	táng
Tanngrisnir	Tangrisznir
Tanngrisniti	tangriszniri
Tannhauser	tánn-hauzer
Tanquerey	tenkörí
Tarantino	tárántínó
Taranto	tárántó
Tarantótól	tárántótól
Tarawa	tárává
Tardieu	tárgyijő
Tardisra	tárdiszra
Tarentum	tárentum
Tarhos	tar-hos
Tari	ta-ri
Tarik	tárik
Tarmgrisnir	tárngrisznir
Tarpon	tar-pon
Tarquinii	tárkvínii
Tarquinius	tárkvínijusz
Tarquinius Superbus	tárkvíniusz szuperbusz
Tarsis	társzisz
Tary Rupert	ta-ri rúpert
Tasmania	tasmánia
Tasmaniában	tasmániában
Tassigny	tásszíni
TASZSZ	tassz
Tata	ta-ta
Tatarcsenko	tatárcsenkó
Tatyjana	tátyáná
Taylor	télor
TBC	tébétcé
TDK	tédéká
Teatro	teátró
Tebrizig	tebricig
Technology	teknolodzsi
Technology Industry Council	teknolodzsi indásztri káunszil
Techonomy	tehonomi
Tecumseh	tekumszeh
TED	ted
Tedder	ted-der
Tedeschi	tedeszki
Tegetthoff	tegett-hoff
Telefunken	tele-funken
Telegram	telegramm
Telegraph	telegráf
Telegraph Company	telegráf kámpöni
Telemakhoszt	télemakhoszt
Telepszichopatikus	tele-pszihopatikus
Telescope	teleszkóp
Telex	teleksz
Tell	tell
Teller	tel-ler
TEM	té-e-em
Temes	temesh
Tencent	tenszent
Tenkes	ten-kes
TENL	té-e-en-el
Tenochtitlan	tenok-titlán
Teotihuacan	teoti-huákán
Tepes	tepesh
Terbosco	ter-boszkó
Terentius	terencijusz
Természetéről	természe-téről
Terra Nova	terra nóva
Terra Salvaesche	terrá szálvájeszke
Terry Yoise	terri józi
Terry Yosie	terri józi
tertia	ter-tcijá
Teschen	tes-sen
Tesla	teszla
Teslának	teszlának
Test Valleyn	teszt vellin
Tetsuo Goto	tetcuó gotó
Teufel	tójfel
Teuffel	tójfel
Tevere	tev-ere
Texas	tekszász
Texasban	tekszászban
Texcoco	teksz-kokó
Tezcatlipoca	teszkátlipoká
Thallus	tállusz
Thalmann	tálmán
Thaly	táli
Thant	tánt
Thapsus	tápszusz
Tharp	tárp
Thaszosz	tásszosz
Thatcher	szecsör
The Army	dö ármi
The Complete Roman Legions	dö kámplít rómen lídzsönsz
The Crucifixion	dö krutcifikshön
The Death	dö desz
The Final Days	dö fájnöl déjz
The Historical Jesus	dö hisztóriköl dzsízösz
The Joy	dö dzsój
The New York Times	dö nyú york tájmsz
The Resurrection	dö rezörekshön
The Roman Army	dö rómen ármi
The Sage	dö szédzs
The Trials	dö trájölz
Thefacebook	dö féjszbúk
Theobald	tiobáld
Theodor Suchy	teodór szuhhe
Theodóra	teod-óra
Theodore	teodór
Theodore Roosevelt	teodór rózevelt
Theodoricnak	teordoriknak
Theodorik	teo-dórik
Theodotidész	teodotidész
Theogoniát	teogóniját
Theophanu	teofánu
Theophiliusz	teo-fíliusz
Theophrasztosz	teofrásztosz
Theoretical Physics	teoretikál fiziksz
Theory	tiöri
Theremin	teremin
Theresianum	terézi-ánum
Theresienstadt	terézijenstátt
Thermopülai	termopűleji
Thérón	térón
Thiel	tíl
Thionville	tijonvill
THM	téháem
Thököly	tököli
Tholoszt	toloszt
Thoma	tóma
Thomas	tomász
Thomas Becket	tomász bekett
Thomas Caldwell	tomász káldvel
Thomas Edison	tomász edizon
Thomas Huxley	tomász hákszli
Thomas Malthus	tomász máltusz
Thomas Moore	tomász mór
Thomas Wedgewood	tomász vedzsvúd
Thompson	tomzon
Thompson-Houston Electric Company	tomzon hjúszton elektrik kámpöni
Thompsonnal	tomzonnal
Thoms Becket	tomász bekett
Thomson	tomzon
Thomson-Houston	tomzon hjúszton
Thor	tór
Thor Heyerdahl	tór hejerdál
Thorazine	torazin
Thorfinnssennel	torfinn-szennel
Thorn	tórn
Thorne	tórn
Thorstein Veblen	tor-shtejn veblen
Thot	tót
Thotmesz	totmesz
Thrakiából Lucullust	trákijából lukulluszt
Thrákiával	trákijával
Thrasyllus	trász-szíliusz
Three Michael Joseph	trí májköl dzsózef
Thugut	tugut
Thul	túl
Thülét	tűlét
Thun	tún
Thurain	turájin
Thüringiába	türingiába
Thurioinak	túriojnak
Thuróczy	turóci
Tiahuanaco	tijáhuánákó
Tiberis	tibe-risz
Tiberius Julius	tibériusz júliusz
Tiberius Julius Augustus	tibériusz júliusz augusztusz
Tiberiust Caprira	tibériusz káprira
Ticies	tícijesz
Ticinus	titcinusz
Tiefenbach	tífen-bach
Tiffany	tifáni
Tigert	tájgört
Tigin	tájdzsin
Tillery	tilöri
Tillich	tilics
Tillius	tilliusz
Tilly	tilli
Time	tájm
Times	tájmsz
Times Bits	tájmsz bitsz
Timesba	tájmszba
Timesnak	tájmsznak
TINA	tina
Tinsel	tinzel
Tisserant	tiszeránt
Titanic	titanik
Titia	tícija
Titicaca	titikaka
Titó	tító
Titulescu	titu-leszku
Titus	títusz
Titus Livius	títusz tívijusz
Titus Sempronius Blaesus	títusz szemproniusz blészusz
Titus Tatius	títusz tacitusz
Titusszal	titusszal
Tiziano	titziánó
Tizianótól Marsyas	ticijánótól márszijász
Tkacsenko	tkacsenkó
TNT	téenté
Tocca	tokka
Toccá	tokká
Tocqueville	tokvill
Todleben	todl-ben
Toledo	toledó
Tolosa	tolóza
Tomiban	tomiban
Tommaso	tomázó
Tommasó	tomázó
Tommy Flowers	tomi fláoörsz
Tony	toni
Tony Abbott	toni ebot
Tony Blair	toni blair
Tony Hill	toni hill
Tonyval	tonival
Toplizi	toplici
Topsy	tápszi
Tornmaso	tomázó
Tornmasó	tomázó
Torstensonn	torsh-tenszon
Tosca	toszká
Toscana	toszkána
Toscaná	toszkáná
Toscanába	toszkánába
Toscanában	toszkánában
Toszkána	toszkáná
Toszkáná	toszkáná
Totten	tóten
Toulonban	tulonban
Tourcoing	tuhrkoán
Toussaint	tüszen
Tower	táoör
Towerbe	táoverbe
Town	táun
Townsend	táunszend
Toynbee Lectures	tojnbi lekcsörsz
TPG	típídzsí
Trade Commission	tréjd kámishön
Trade Union Congress	tréjd junion kángrössz
Traianus	trájánusz
Transalpinának	transzalpinának
Trans-Amsok	transz amsok
Transsylvániáról	transzilvániáról
Transtiberisen	transz-tiberiszen
Transvaal	transzvál
Trapezosznál	trápezosznál
Trasbarg	trász-bárg
Trasimenus	trázimenusz
Travail	trávéjl
Travelocity	távelosziti
Travis Kalanick	trevisz kelenik
Traynham	tréjnhem
Trebia	trebija
Treitschke	trejcske
Tremont	tre-mont
Tremont Street	tre-mont sztrít
Treuga	treuga
Trevane	trivéjn
Trevor Toronyhoz	trevor toronyhoz
Trevor Towersben	trvor táoerszben
Trey Eight Crip	tréj éjt krip
Trianon	tria-non
Tribe	trájb
Trible	trájböl
Tribun	tribün
Tricia	trísa
Triciának	trísának
Trillant	trilent
Trillman	trill-man
Trimalchio	trimálcsijó
Trimble	trimböl
Tripadvisoron	tripödvájzoron
Triparadeiszoszban	triparadejszoszban
Tripartitum	tripar-titum
Tripoli	tri-poli
Trisjam	trísz-dzsem
Trockij	troc-kíj
Troels Lund	trőlsz lund
Troyes	throá
Truk	trúk
Truman	trú-man
Trump	trámp
Trunco	tránkó
Truro	trúró
Trust	trászt
Truxton	tráksztön
Tsath	tszát
Tsathoggua	tszátoggua
Tsathogguá	tszátogguá
Tucker Carlson	tákör kárlszon
Tudor	tyúdor
Tufts	táftsz
Tuilleriákat	tülérijákat
Tulagi	tulági
Tullianumnak	tullijánumnak
Tullius	tullijusz
Tulsa	tálszá
Tunguska	tunguszka
Turbine	törbájn
Turgot	turgó
Turin	túrin
Turing	tyúring
Turkana	turkána
Turok	tyúrok
Turulmonda	turul monda
Tuscaloosa	tuszkálósza
Tusratta	tuszratta
Tutanhamon	tuten-hámon
Tutanhaton	tuten-háton
TV	tévé
Tvvaint	tvéjnt
Twain	tvéjn
Twamley	tvemli
Twitter	tvitter
Tycho	ticsó
Tydfihiek	tídfihijek
Tydfil	tídfil
Tyerek	tyerek
Tyimosenko	tyimosenkó
Tylenol	tilenol
Tyler	tájler
Tyler Winklevosst	tájlör vinölvosszt
Tyneside	tájnszájd
Tyrannosaurus	tirannoszaurusz
Tyre	tír
Tyroshoz	tűroszhoz
Tzeitung	cájtung
Tzimiszkész	tcimiszkész
Uber	űber
UEFA	úefa
Uermis Mysteriis	vermisz miszterísz
Uffizi	ufici
UFO	ufó
UGG	úgégé
UHF	úháeff
UHL	úháell
Uhrt	úrt
Újságban	újs-ágban
UKDMC	úkádéemcé
Ulpianusnak	ulpijánusznak
Ulpianust	ulpijánusz
Ulsterba	ulszterba
Ulsterre	ulsz-terre
Ulterior	ulterijór
Ulthar	últár
Ultra	ult-ra
Ulvi Yurtseverrel	ulvi ürtszeverrel
umgelegt	umgelégt
una vers catholica fides	úná versz kátóliká fídesz
Unam Sanctam	únám szánktám
Undenvood Johnson	ándörvúd dzsónzon
Underwood Johnsonnak	ándörvúd dzsónzonnak
UNESCO	uneszkó
Ungaria	ungárija
Union	júnion
United States Steel	junájtid sztéjtsz sztíl
Universal	junivörzál
University	junivörziti
University Avenue	juniverziti evönyú
Univesity	junivörziti
UNK	úenká
UNRRA	ú-en-err-err-a
Unterwalden	unterválden
Upholder	áphóldör
Upton Sinclair	áptön szinkler
Uranosz	uránosz
Urat	u-rat
Urban	urbán
Uros	úrosz
Ursa Minor	urza mi-nor
Ursa Minos 	urza mi-nor
Ursula	urszula
USPD	ú-esz-pé-dé
Ussher	ásör
Utah	jutah
Utahban	jutában
Utica	útika
Uugh	úh
UV	úvé
Uxbridge	ákszbridzs
Uxellodunum	uksze-lódunum
Uzuldaroum	uzuldárórum
Vaagsónál	vágsónál
Vafa	váfá
Valdes	váld
Valdo	váldó
Valenciából	válen-szijából
Valens	válensz
Valentinianus	válentinijánusz
Valera	vále-rá
Valerius Gratus	váleriusz grátusz
Valéry Giscard	váleri zsiszkár
Valhalla	val-halla
Valiant	válirán
Valide	válíd
Valladolid	vélléndolid
Valletta	val-etta
Valois	váloá
Valusia	valúszija
Valusiához	valúszijához
Vandalica	vándáliká
Vander Kloot	vánder klút
Vanderbiltnek	vánderbiltnek
Vang	váng
Vanita	vánitá
Vanity Fair	veniti fe-r
Vansittart	vánszittárt
Vargas	várgász
Varkoch	var-kocs
Varro	varró
Varro Lucullust	várró lukulluszt
Vasa	vaaszá
Vasco	vászkó
Vaslady	vaslédi
Vasquez	vászkez
Vassar	vászár
Vassillian	vászilijen
Vassy	vásszi
Vaucanson	vokánszon
Vaux	vő
Vayrac	vájrák
Veagh	víg
Veblen	véblen
Vecchio	vecs-csijó
Vecchió	vecs-csijó
Vedano	vedánó
Veesenmayer	vézen-májer
Vega	vega
Vegas	vegász
Vela	velá
Velbudzsnál	velbudzsnál
Velcro	velkró
Vellmore	velmór
Vemer	ver-ner
Vend	vend
Veneris	venerisz
Venezia-Giuliába	venedzija dzsúlijába
Veneziano	venedzsijánó
Veni, vidi, vici	veni, vidi vícsi
Venus	vénusz
Venustiano Carranzának	venusztijánó kárrándzának
Vera	verá
Veracruz	verákrúz
Verd	verd
Verdun	verdön
Verdunt	verdönt
Vereenigingbe	förénehingbe
Vereenigingnél	förénehingnél
Verge	vördzs
Vergeltung	ferfeltung
Vergilius	vergílijusz
Verizon	vörzsön
Vermandois	vermándóisz
Vermont Royster	veermont rojszter
Verres	verresz
Verseghy	versegi
Versewald	verz-váld
Versinyin	verzinyin
Verus	verusz
Vervactor	verváktor
Very Large Array	veri lárdzs öréj
Very Large Baseline Array	veri lárdzs béjzlájn öréj
Verzion	vörzsön
Vese	véze
Vespasianus	veszpázijánusz
Vespucci	veszpuccsi
Vesta	veszta
Vesto	vesztó
Vesto Slipher	vesztó slifer
Veteranit	veteránit
Vetsera	vecsera
Vetter	vet-ter
Veurnén	vörnén
Veurnétől Nieuwpoortig	vörnétől nijőportig
VHF	véháeff
Via Dolorosa	víja doloróza
Viacom	vájakom
Vian	vijen
vicarius Christi	vikáriusz kriszti
Vichy	visi
Vichyvel	visivel
Victor Hess	viktor hessz
Victor Mallettől	viktor mállettől
Victoria	viktória
Victorious	viktórijösz
Victory	viktori
Vida	vi-da
Vidkun Quisling	vidkun kvizling
Vienne	vín
Viersen	fírzen
Vietnam	vijetnám
Vigna	viny-nyá
Vigná	viny-nyá
Vigus	vígusz
Viipuri	vípuri
Villa	Víjja
Villa Jovist	víjja hóviszt
Villa Rivaltában	víjá riváltában
Villafrancában	víjjafrankábn
Village	vilidzs
Villámisten	villám-isten
Villának	víjjának
Villard	vilárd
Villarreal	víjjáreál
Villele	vilel
Vilna	vilna
Vilniustól	vilniusztól
Viltvodle	vilt-vódl
Vincennes	vanszen
Vindhya	vindüa
Vindleswoshen	vindölz-vósen
Vindlewoshen	vindöl-vósen
Vine	vájn
Vipsania	vipszánia
Virasoro	virászóró
Vire	vír
Virgin	vördzsön
Virginiá	virdzsíniá
Virginiában	virdzsínijában
Virginiai	virdzsínia
Virginiát	virdzsíniát
VIRGO	virgó
Visconti	viszkonti
Vishnal	visnál
Visinszkij	vis-insz-kíj
Visnut	vis-nut
Visoianunak	viszojánunak
Visser	visz-szer
Vissiere	viszijer
Vita Caroli	vítá károli
Vitale	vitále
Vitális	vitálisz
Vitruvius	vitruvijusz
Vittorio Veneto	vittórijó venettó
Vittorio Venetó	vittórijó venettó
Vitus	vítusz
Vivekananda	vivekánádá
Vizcayai	vizkájjái
Vlad	vlád
Vlad Drakul	vlád drákul
Vladimirescu	vládimireszku
VLBA	véelbé-a
Vliegenhart	vlígen-hárt
Vliet	vlít
VOC	víószí
Vogt	vógt
Volga	vol-ga
Völkischer Beobachhter	fölkiser beobakter
Völkischer Beobachter	fölkiser beo-bah-ter
Volodimir Zelenszkij	vologyimír zelenszkíj
Volsinii	volszíni
Volson Wood	volzon vúd
Völsunga	völ-szunga
Voltaire	vol-ter
Voojagig	vúdzságig
Vorarlberget	forár-berget
Voroncov	voronkov
Vouglénál	vúgöl
VPN	vépéen
VR	víár
Vratiszlav	vrátyiszláv
Vroomfondel	vrúmfondel
VSZ	vé-essz
Vuillemin	müjimán
Vukovics	vukovics
Waco	vákó
Wael Ghonim	váel gonim
Waffen	váf-fen
Wagner	vágner
Walcheren	válheren
Waldorf	valdorf
Waldorf-Astoria	valdorf asztória
Waldsee	váldzé
Wales	velsz
Walewska	válevszka
Walewski	válevszki
Walgreens	vólgrínsz
Walhalla	val-halla
Wallen	vállen
Waller	váller
Walney	válni
Walpole	válpól
Walt Disney	valt dizni
Walt Mossberg	volt mossz-berg
Walter	vol-ter
Walter Baade	volter vád
Walter Moyne	vol-ter mojn
Walter Raleigh	vol-ter réjli
Walther	vol-ter
Waltherekhez	valterekhez
Walz	váltc
Wang	váng
Wanklyn	vánklin
Wannseeben	vánn-zében
Ward	vórd
Ward Phillips	vórd filipsz
Wardenclyffe	vórdenkliff
Wardenclylfe	vórdenkliff
Wardlaw-Milne	várdláv milne
Warfield	vórfíld
Warner	vórner
Warren	vóren
Warspite	vórszpájt
Wartha Vince	varta vinsz
Warwickshire	vórviksír
Wash	vás
Washingtonba Jimmy Price	vasingtonba dzsimi prájsz
Washingtonból	vasingtonból
Washingtonnak	vasingtonnak
Washingtonra	vasingtonra
Washingtont	vasingtont
Washtol	vástol
Wasp	vaszp
Wasserman Schultz	vásszer-mán shultc
Watch	vacs
Watergate	vótörgéjt
Waterloo	vaterló
Waterlooéval	vaterló-éval
Waterlooi	vaterlói
Waterside	vóterszájd
Watfordban	vátfordban
Wathay	vatai
Watson	vátszon
Watson-Watts	vátszon vattsz
Watt	vatt
Waugh	vón
Wavehiél	véjvhiél
Wavel	vével
Wavell	vável
Wavre	vávr
Wayne	véjn
WC	vécé
Weaver	vívör
Weber	véber
Wechler	vekszler
Wechsler	vekszler
Weddel	veddel
Wedeker	védeker
Weedon	vídon
Weeklv	víkli
Weekly	víkli
Wehrkreisra	verk-rájszra
Weibo	vájbő
Weichsel-UnionMetallwerke	vájkszelunión metálverke
Weimar	vej-már
Weimari	vejmári
Weinberg	vájn-berg
WEIRD	vírd
Weismüller	vejszmüller
Weisungen	vájszungen
Weizsacker	vájc-záher
Welchman	velh-man
Wellington	vellington
Wells	velsz
Welserek	velzerek
Weltpolitik	veltpolitík
Wenckheim	venk-hejm
Wendell Willkie	vendel vilki
Wendy	vendi
Werner	ver-ner
Werner Heisenberg	verner hejzenberg
Wernher	ver-ner
Werther	ver-ter
Wesel	vézel
Wesselényi	veselényi
Wessex	veszeksz
Wesson	vesszon
West	veszt
West Country	veszt káuntri
West Side	veszt szájd
West Side Storyban	veszt szájd sztoriban
West Village	veszt vilidzs
West Virginia	veszt virdzsínija
Westbe	vesztbe
Westchester	veszt-csesztör
Western Union	vesztern júniön
Westinghouse	vesztinháusz
Westinghouse Science Talente Search	vesztingháusz szájensz telönt szőrcs
Westminster	vesztminszter
Westminsterbe	vesztminszterbe
Westtől	veszttől
Wexler	vekszler
Weygand	véjgrán
Weyl	vejl
Weymouth	véjmáusz
Weymouthig	vájmáuszig
WFUL	véefú-ell
What	vát
Wheeler	vílör
Whetstone	vet-sztón
Whitby	vitbi
White	vájt
Whiting	viting
Whitley	vitli
Whitman	vit-man
Whitwham	vit-vem
WHO	véháó
WIC	duplavé í cé
Wickbe	vikkbe
Wicker	vikör
Widener	vájdenör
Widukind	vidukind
Wiedemann	víde-mánn
Wien	vín
Wiesenthal	vízentál
Wiesse	vissze
Wiesseebe	vísz-zébe
Wigner	vigner
Wigram	vigrám
Wilczek	viltcek
Wilfordba	vilfordba
Wilhelm	vilhelm
Wilhelm Heinrich Olbers	vilhelm hejn-rich ol-börsz
Wilhelm Lenzet	vilhelm lencet
Wilhelm Liebknecht	vilhelm líbnekt
Wilk	vilk
Wilkes	vilkiz
Wilkinson	vilkinzon
Will	vill
William	vilijem
William Blake	vilijem bléik
William Cecil	vilijem szeszil
William Draper	villijem drepör
William Dyer	vilijem dűer
William Gladstone	vilijem gládsztón
William Hill	villijem hill
William Laud	viliem la-ud
William Paget	viliem pedzset
William Pitt	viliem pitt
William Shakespeare	vilijem sékszpír
William Tierney Clark	vilijem tírnei klárk
William Tyndale	viliem tindél
Williams	villijemsz
Williams Sandberg	vilijem szend-berg
Williamson	vilijemszon
Williani Strutt	vilijáni sztrátt
Willingham	vilingem
Willinghan	vilingem
Willkie	vilki
Willlam Fowler	villem fóler
Willner	vilnör
Willoughby	vilobi
Willy Brandt	villi bránt
Wilma	vil-ma
Wilmarth	vilmárt
Wilson	vilzon
wilsoni	vilzoni
WIMP	vimp
Winant	vinent
Winchester	vincseszter
Winchestert	vincsesztert
Windexszel	vindeksz-szel
Windsor	vindzor
Winficld	vinfíld
Winfield	vinfíld
Winfried Otto Schumann	vinfríd ottó shúman
Wingate	vingéjt
Winston	vinszton
Wirathu	virátú
Wirklichkeit	vírklih-kájt
Wisbyben	vizbiben
Wismarnál	viszmárnál
Wissembourg	visszenbúrg
Witos	vitosz
Wittelsbach	vittelsz-bach
Witten	vit-ten
Wittenberg	vitten-berg
Witzleben	víclében
Wladyslaw	vládisz-láv
Wladyslaw Sikorski	vládiszláv szikorszki
WMAE	véem-a-e
WMAP	véem-a-pé
Woid	vojid
Wolf Blitzer	volf biltcer
Wolfgang Gerha	volfgáng gerhárd
Wolfgang Gerhard	volf-gáng gerhárd
Wolfgang Pauli	volf-gáng pau-li
Wolfgang Puchaim	volf-gáng pukhájm
Wolfram	volf-rám
Wollaston	volászton
Wollgang Gerhard	volfgáng gerhárd
Wolsey	vúlzi
Wolverine	volverín
Wooden Horse	vúdön hórsz
Woodsman	vúdsz-men
Woody Allen	vúdi el-len
Woolsthorpe	vúlsztorp
Woomera	vúmerá
Wooster	vúsztör
Workplace	vörkszpéjsz
World Telegramban	vörd telegramban
World Trade Center	vörd tréjd center
Worm	vórm
Worms	vo-ormsz
Worthing	vorszing
Wowbaggemél	vóv-begger-nél
Wowbagger	vov-begger
WPIK	duplavé, pé-íká
WPOQ	duplavé, pé-ókú
Wratten	vrettön
Wren	vren
Wright	vrájt
Wroclaw	vronszláv
Würzburg	vürc-burg
Wyclif	víkliff
Wyman	víájmen
Wyoming	vájoming
Wytschaete	vücsá-et
WZA	duplavé-zéj-a
Xanthippé	kszantippé
Xanthipposz	kszantiposz
Xari	kszári
Xaxis	kszákszisz
Xenophón	kszenofón
Xerox	kszeroksz
XFN	exefen
XHTLOA	ikszháté-eló-a
Xiphodon	zifodon
XMM	ekszemem
Xura	zúrá
Yaddith	jádit
Yahoo	jáhú
Yale	jél
Yardnak	jardnak
Yáth	ját
Yazoo	jázú
Ychune	ihune
Yehudi Menuhin	jehudi menuhin
Yggdrasil	ügdrázil
Yjenean	ödzínen
Yoda	ioda
Yona	jóna
Yooden	júden
York	jork
Yorkerben	jorkerben
Yorkot	jorkot
Yosie	józi
Youks	juksz
Young	júng
Yovellnek	jovellnek
Ypern	ipern
Yser	iszer
Ysllodins	iszlodinsz
Yucatán	jukatán
Yuckum	júkum
Yuggoth	júgot
Yuste	zsüszt
Yuval Noah Harari	jüvál noá hárári
Yvon	ívon
Zabush	zábus
Zadrozny	zádroznyíj
Zairét	zajrét
Zalasd	zalashd
Zama	számá
Zamojski	zámojszki
Zamoyski	zámojszki
Zamphourt	zámfórt
Zante	zánte
Zanzellquasur Flamarion	zánzelkvászur flámárijon 
Zapata	szápátá
Zaph	záf
Zaphod 	záfod
Zaphod Beeb	záfod bíp
Zaphod Beeble	záfod bíböl
ZAPHOD IGENT MOND ZAPHODRA	záfod igent mond záfodra
Zaphod Quantus Beeblebrox	záfod kvántusz bíbölbroksz
Zaphy	zsáfi
Zapliodra	záplijodra
Zara	zárá
Zarathustra	zara-tusztra
Zark	zárk
Zarniwoop	zárnivúp
Zarqnon	zárk-non
Zarss	zársz
ZB	zébé
Zealand Star	zélánd sztár
Zeeland	zéland
Zelenszkij	zelenszkíj
Zeligowski	zeligovszki
Zemljanicáért	zemljánicáért
Zenig	zenig
Zephyrus	zefirusz
Zerubbabel	zerubbábel
Zervaszt	zervászt
Zeusszal	zeu-sszal
Zeusz	zeu-sz
Zeuxisz	zeukszisz
Zichy	zicsi
Zieten	cíten
Ziher-Dajng Foton	zíher-dájng foton
ZIL	zíl
Zimmermann	cimmer-man
Zimony	zimony
Zimonyban	zimoniban
Zipernowszky	tcippernovszkíj
Zipo	zipó
Zircon	cirkon
Zirzla	zir-zlá
Zkauba	zkúba
Zola	zóla
Zollverein	tzollferájn
Zondostina	zondosztína
Zooey Deschanel	zojé desánel
Zoom	zúm
Zoufonoun	túfonáun
Zsepi	zsepi
Zsitomirt	zsitomirt
ZTE	zété-e
Zucker	tcuk-ker
Zuckolva	tcukkolva
Zuhr	cúr
Zürichben	tcürichben
Zürichből	cürihből
Zurückerinnerungen	curükk-erinnerungen
Zuyder	zújder
Zuyderzeeig	zújder-zéig
Zweig	tcvájg
Zwicky	tcviki
Zwingler	tcvinger
Zygmunt	zügmunt
Zyklon	ciklon
Zymierski	zimírszki
ZZ	zézé
Vigliottinak	vijottinak
Georginának	dzsordzsának
Brrrrrmmmmm	brumm
Clemmensnek	klemensznek
Speedójával	szpídójával
Bernadette	bernadett
Rubinstein	rubin-stejn
Alapítvány	alapítvány
Amherstben	ámersztben
Garagounas	gárágönász
Hinckesman	hinköszman
Depardieu	depárgyijő
Elismered	elism-ered
Kennerley	kenörli
Langleben	lengliben
Monicával	mónikával
Parkinson	párkinzon
Pinocchio	pinokkijó
Rochester	rócseszter
Sharonnal	seronnal
Sylvester	szilveszter
Willishez	viliszhez
Dianának	dájánának
Dianával	dájánával
Georgina	dzsor-dzsina
Gilligan	giligen
Lewinsky	lujinszki
Loiraine	loréjn
Lorraine	loréjn
Mehrtens	mrtensz
Michelin	mislen
Okavango	okávángó
Patricia	pátrisá
Petomane	petömen
Rosemary	rózméri
Sheelagh	sílág
Simmoads	szimoádsz
Stallone	sztálóne
Superman	szupermen
Torontől	torontói
Universe	junivörz
Angelis	ándzselisz
Camilla	kamilla
Cranium	kránijum
Egyesük	egyesült
Egyetem	egyetem
Feldman	feld-man
Florida	flor-ida
Hitchon	hics-cson
Hycocks	hikáksz
Jessica	dzsesszika
Justine	zsüsztin
Karának	karának
Opiumot	ópijumot
Playboy	pléjboj
Rantzen	rántcen
Ritchie	rics-csi
Sharont	seront
Waitley	véjtli
Wuensch	vüns
Batman	betmen
Helena	heléna
Jeremy	dzseremi
United	junájtid
Barrie	berri
Bemard	bernárd
Borneo	borneó
Cavill	kéjvil
Clarke	klárk
Cruise	krúz
Damian	démijen
Debbie	debi
Dennis	denisz
Dianna	dijáná
Dianát	dájánát
Donuts	dónátsz
Franre	frenre
Garner	gárner
Greame	gre-em
Hansen	henszen
Hedger	hedzsör
Hentai	hentáj
Hutnál	hútnál
Jehova	jehova
Juliát	dzsuliját
Kimmel	kim-mel
Margie	márdzsi
Martin	mártin
Monica	mónika
Morris	morisz
Nathan	nátán
Orvosi	orvosi
Renoir	rönoár
Speedo	szpídó
Tarzan	tárzán
Tracey	trészi
Travis	trevisz
Trevor	tre-vor
Viagra	vija-gra
Victor	viktor
Yvonne	ivón
Carol	kerol
Geoff	dzsoff
Barry	berri
Black	blekk
Boggs	boggsz
Danid	dánid
Downs	dáunsz
Dufty	dáfti
Earle	őrl
Gerri	gerri
Irene	iréne
Jenny	dzseni
Jodie	dzsodi
Julie	dzsuli
Katie	keti
Kelly	keli
Lisát	liszát
Lyons	lijonsz
Maria	máríjá
Nigel	nájdzsel
Olive	olív
Pizza	pizza
Pojul	podzsul
Proud	práud
Péter	péter
Rothe	rót
Rouge	rúzs
Singh	színg
Women	vimin
Zorro	zorró
Adám	ádám
Andy	endi
Anna	anna
Bank	benk
Brad	bred
Dale	déjl
Dana	dáná
Fred	fred
Greg	greg
Jade	dzséjd
Josh	dzsos
Know	nó
Lady	lédi
Lane	lén
Mary	méri
Miss	missz
Nagy	nagy
Rayt	réjt
Ruth	rút
Want	vánt
IQ	íkú
Albuquerque	álbukörki
Apperson	epörszon
Ashfork	esfork
Bethany	betöni
Beverly-Wilshire	beverli-vilsír
Bromo	bromó
Bunyan	bunyán
Carl	kárl
Centró	centró
Chacotah	csákotá
Chalmers	csálmersz
Cherokee	cseroki
City Transport Company	sziti transzport kámpöni
Colmato Hotelben	kolmátó hotelben
Connie	koni
Conway	konvéj
County	káuntri
Cowlington	kólington
Diesel	dízel
Edmond	ed-mond
Flash	fles
Geronimo	dzseronímó
Gilla	dzsillá
Grande	grán-de
Guerrero	gerrerró
Hooper	húpör
Hooversville	húvörszvill
Hooverville	húvörvill
Huligán	hul-igán
Huston	hjúszton
Joad	dzsód
Joseph City	dzsozef sziti
Kingman	kingmen
Knowles	nólíz
Laredo	lárédó
Lincoln Zephyr	linkoln zefír
Lisbeth	lizbet
Lunas	lúnász
Macban	mákban
Meeker	míkör
Bakersfield	ékörszfíld
Mojave	moháve
Moutain View	máuntön vjú
Muley	máli
Muskogee	mászkágí
Noah	noá
Oatman	ót-men
Padenig	pedöning
Pecos	pekosz
Pontiac	pont-iják
Reno	rénó
Roebuck	rőbukk
Rudolph	rud-olf
Ruthie	ruti
Sairy	szeri
Salinas	szálinász
Salle	száll
Sallisaw	szeli-só
Sanata Rosa	szántá-rószá
Sandry	szendri
Santa Clara Valley	szántá-klárá veli
Santa Fé	szántá-fé
Santa Rosá	szántá-rószá
Shafter	sefter
Shamrock	sámrokk
Shawnee	sóní
Sotók	szotók
Sunland	szánlend
Super Six	szuper-sziksz
Suter	szátör
Techachapi	tekácsepi
Terillo	terilló
Texola	tekszóla
Texoláig	tekszóláig
Timothy	timoti
Tulare	tálári
Tulsá	tálszá
Turnbull	törn-bull
Wainwright	véjnrájt
Wallace	válász
Chacotah	csákotá
Wichita Falls	vicsita fólsz
Willis	vilisz
Zephyr	zefír
