Chlodwig Hohenlohe-Schillingsfürst	kodvig hóhnlóhe shilling-fürsht	34
Juridisch-Politischer Leseverein	juridísh-politísher lezöverín	32
Johann Caspar Ampringent	yohán kászpár amprazsón	24
Enea Silvio Piccolomini	eneá szilvió pikkolomíni	23
Constitutio Criminalis	konsztitúció kriminálisz	22
Maximilien Robespierre	mekszimilijen robeszpijer	22
Pierre-Joseph Proudhon	pijer-zsozef prudon	22
Venustiano Carranzának	venusztijánó kárrándzának	22
Gianbattista Castaldo	dzsijánbáptisztá kásztáldó	21
Jean-Jacques Rousseau	zsán-zsákk russzó	21
Raimondo Montecuccoli	rájmondó montekukkoli	21
Henry Morton Stanleyt	henri morton sztenlit	21
Louis-Auguste Blanqui	lují ogüszt blankí	21
Barbarossa Hairaddin	barbarossza hájrádin	20
Collegium Germanicum	kollégium germánikum	20
Collegium Hungaricum	kollégium hungárikum	20
Georges-Louis Buffon	zsorzs-lují bufon	20
Florence Nightingale	florensz nájtingél	20
Trade Union Congress	tréjd junion kángrössz	20
Ferdinand Hardegget	ferdinánd hárdegget	19
Gesta Hungarorumban	gesta hunga-rórumban	19
Cornelius Jansenius	kornéliusz janzenikusz	19
Diploma Leopoldinum	diploma leopoldium	19
Joachim Winckelmann	joá-chim vinkölman	19
Constantin Bratianu	konsztantin brátyánu	19
Felix Schwarzenberg	félix shvártzen-berg	19
Balthasar Simunich	baltazár szimunics	18
Berneczki Katarina	bernetzki kátáríná	18
Pallavicini Sforza	páláviccsíni szfortza	18
Jérome Napoléonnak	zsérom napóleonnak	18
George Washingtont	dzsordzs vasingtont	18
Richard Chancellor	ricsárd csenszölor	18
Roberto Bellarmino	robertó belármínó	18
Rotterdami Erasmus	rotter-dámi erászmusz	18
David Lloyd George	déjvid lojd dzsordzs	18
Emmeline Pankhurst	emölin pánkhörszt	18
Ferdinand Lassalle	ferdinánd lázál	18
Georges Clemenceau	zsorzs klemenszó	18
Joseph Chamberlain	dzsozef csembörléjn	18
Mannheimer Zeitung	mánnhejmer tzájtung	18
Pragmatica Sanctió	pragmatika szankció	18
Theodore Roosevelt	teodór rózevelt	18
Wilhelm Liebknecht	vilhelm líbnekt	18
Bernardo Gabellio	bernárdó gábejjió	17
Marquis Chasteler	márkí shásztöler	17
Ottavio Baldigara	ottávió báldigárá	17
Benjamin Franklin	bendzsámin frenklin	17
General Statennel	dzsenerál sztetönnel	17
Hieronymus Laskit	hijerónimusz lászkit	17
Louis Montesquieu	lují monteszkijő	17
Ratio Educationis	ráció edukációnisz	17
Tadeus Kosciuszko	tádeusz kosz-ciusz-kó	17
Benjamin Disraeli	Bendzsámin dizráeli	17
Robespierre-Marat	robeszpijer-márát	17
Ferdinand Lesseps	ferdinánd löszepsz	17
Frantisek Palacky	frántiszek plákki	17
Giovanni Giolitti	dzsovánni dzsolitti	17
Joszip Jelasicsot	joszip jelashicsot	17
Nathan Rothschild	nátán rótcsíld	17
Shultze-Delitzsch	shultz delits	17
William Gladstone	vilijem gládsztón	17
Georg Paradeiser	ge-org párá-dízer	16
Homonnai Drugeth	homon-nai drúget	16
Wolfgang Puchaim	volf-gáng pukhájm	16
Charlotte-Amalie	shárlott ámelí	16
Maria Antoinette	márí ántoánett	16
Marie Antoinette	márí ántoánett	16
Siegbert Heister	zígbert hájszter	16
Agustín Iturbide	agusztín iturbídé	16
Emiliano Zapatát	emílió szápátát	16
Francesco Crispi	fráncseszkó kriszpi	16
Giuseppe Mazzini	dzsuzeppe máddzíni	16
Lord Castlereagh	lord kászölöre	16
Ludwig Feuerbach	ludvig fójer-bach	16
Raymond Poincaré	rájmond poánkáré	16
Toynbee Lectures	tojnbi lekcsörsz	16
Credit Mobilier	kredit mobilijé	15
Erasmus Teuffel	erászmusz tójfel	15
Giacomo Durando	dzsákomó durándó	15
Antimachiavelli	anti-mákjávelli	15
Giovanni Medici	dzsovánni medicsi	15
Giuliano Rovere	dzsuliánó róvere	15
Lodovico Gritti	kodovíkó grit-ti	15
Mogul Birodalom	mo-gul birodalom	15
Oliver Cromwell	oliver-króm-vell	15
Robert Devereux	robert derevő	15
Schmalkaldenben	shmal-kaldenben	15
William Tyndale	viliem tindél	15
Daily Telegraph	déjli telegráf	15
Dumitru Sturdza	dumitru szturdza	15
Emiliano Zapata	emílió szápátá	15
Georgiu Baritiu	dzsórdzsu báritu	15
Lord Palmerston	lord pálmerszton	15
Milos Obrenovic	milosh obrenovics	15
Moltke Sedannál	molt-ke szedánnál	15
Nicolas Chauvin	nikolá shovan	15
Pancho Villának	páncsó víjjának	15
Rudyard Kipling	rádzsörd kipling	15
Daniel Speckle	dániel szpekl	14
Giovanni Doria	dzsovánni dorija	14
Kompolthyakkal	kompol-tiakkal	14
Miguel Serveto	migel szervetó	14
Robert Walpole	robert velpól	14
Walter Raleigh	vol-ter réjli	14
Alfred Dreyfus	elfred drejfusz	14
Georges Danton	dzsorzs dánton	14
Kapodisztriast	kapodi-sztriászt	14
Lola Montezhez	lolá montezhez	14
Ludwig Cobenzl	ludvig kobenszl	14
Siemens-Martin	szímensz mártin	14
Thomas Malthus	tomász máltusz	14
Villafrancában	víjjafrankábn	14
Camillo Benso	Kámilló benszó	13
Giulio Turcho	dzsúlió turcsó	13
Ignaz Lederer	ignátz léderer	13
Cesare Borgia	csezáre bordzsa	13
Czartoryskiak	tzartoriszkiak	13
Denis Diderot	denisz didró	13
Franche-Comte	fransh komt	13
Habeas Corpus	hábeász korpusz	13
Immanuel Kant	imánuel kánt	13
Jules Mazarin	zsüll mázárin	13
Karl Mansfeld	kárl mánsz-feld	13
Massachusetts	meszecsúszetsz	13
Nikolsburgban	nikolsz-burgban	13
Saint-Germain	szen-zsörmen	13
Societas Jesu	szoszijetász yezu	13
Stefan Razvan	sztefán rászván	13
William Cecil	vilijem szeszil	13
William Paget	viliem pedzset	13
Barbarossának	barbarosszának	13
Hernán Cortés	hermán kortesz	13
Königsbergben	kőnigsz-bergben	13
Ballhausplatz	báll-hausz-plátz	13
Beecher-Stowe	bécher sztóv	13
Benito Juárez	Benító húárez	13
David Ricardo	déjvid rikárdó	13
Epidauroszban	epida-uroszban	13
Kasszandrához	kasz-szandrához	13
Lord Cardigan	lord kardigán	13
Matthew Perry	mettyú perri	13
Benito Juarez	benító huárez	13
Neervindennél	nervindnél	13
Porfirio Díaz	porfírijó diáz	13
Saint-Antoine	szen-ántoán	13
Schwarzenberg	shvártzn-berg	13
Simón Bolívar	szimón bolivár	13
Joseph Turin	jozef túrin	12
Kara Ibrahim	kara ibra-him	12
Badeni Lajos	bádeni lajos	12
Chateubriand	shátobijan	12
Draskovichok	drashkovicsok	12
Grand Armada	gránd ármádá	12
Hohenzollern	hohhen-tzollern	12
Montecuccoli	monte-kukkoli	12
Robert Clive	robert klív	12
Tenochtitlan	tenok-titlán	12
William Laud	viliem la-ud	12
William Pitt	viliem pitt	12
Barcelonában	barszelónában	12
Contratación	kontradikszión	12
Höchstadtnál	hőshtáttnál	12
Pennsylvania	penszil-vánia	12
Philadelphiá	filadelfiá	12
Resolutióban	rezolúcióban	12
August Bebel	auguszt bébl	12
Buenos Aires	buenosz ájresz	12
Choveve Cion	shovev tzión	12
Claude-Henri	klód anri	12
Guayaquilben	gvájákilben	12
Ledru-Rollin	lödrü rolan	12
Lombardiából	lombardiából	12
Ludwig Börne	ludvig börn	12
Kogalniceanu	kogálnicsánu	12
Saint-Cloude	szen-klód	12
Schwechatnál	shvehát	12
Tuilleriákat	tülérijákat	12
Vladimirescu	vládimireszku	12
Vorarlberget	forár-berget	12
Avram Iancu	ávr-ám jántzu	11
Beckensloer	bekken-szlóer	11
Carlo Theti	kárló tetti	11
Czibak Imre	tzibak imre	11
Orban Suess	orbán zűsz	11
Sbardellati	szbárdelátti	11
Tary Rupert	ta-ri rúpert	11
Ferraboscót	ferráboszkót	11
Augsburgban	augsz-burgban	11
Brandenburg	bránden-burg	11
Christianae	krisztijen	11
Connecticut	kánektikát	11
Eidgenossen	ájdge-nosszen	11
Falkenstein	fálken-shtejn	11
George Monk	dzsordzs monk	11
Lala Mehmed	lálá meh-med	11
Leszczynski	lesz-tzinszki	11
Marlborough	marl-boró	11
Mississippi	missziszipi	11
Montesquieu	monteszkijő	11
Pazmaneumot	pázmáneumot	11
Pedro Lasso	pedró lásszó	11
Pillnitzben	pilnitzben	11
Piri Mehmed	piri meh-med	11
Poniatowski	pony-tovszki	11
Radu Serban	radu szerbán	11
Saint Denis	szent denisz	11
Salvadornak	szálvádornak	11
Schleswiget	shlesz-viget	11
Shakespeare	shékszpír	11
Starhemberg	sztárem-berg	11
Theresianum	terézi-ánum	11
Torstensonn	torsh-tenszon	11
Tripartitum	tripar-titum	11
Wallenstein	vállen-shtejn	11
Wittelsbach	vittelsz-bach	11
Castaldónak	kásztáldónak	11
Flandriában	fla-ndriában	11
Flandriával	fla-ndriával	11
Thüringiába	türingiába	11
Beauharnais	böárné	11
Camphausent	kámphauzent	11
Carranzának	kárándzának	11
Chamberlain	csembörléjn	11
Changarnier	shenzsönyijé	11
Goluchowski	glushovszki	11
Innsbruckba	insz-brukba	11
Jules Ferry	zsüll ferri	11
Jules Grévy	zsüll gréjvi	11
Karlsbadban	kárlsz-bádba	11
Kronstadtba	króm-státtba	11
Kulturkampf	kultúr-kámpf	11
Lord Raglan	lord ráglán	11
Mississippi	misziszipi	11
Robespierre	robeszpijer	11
Saarbrücken	szár-brükkben	11
Tocqueville	tokvill	11
Celemantia	klemencia	10
Demoiseaux	demoázó	10
Ferrabosco	ferráboszkó	10
Herbeville	herbevill	10
Konstantin	konsh-tantin	10
Neustadter	nój-shtátter	10
Paradeiser	párádízer	10
Steinville	shtejn-vill	10
Strattmann	shtrátt-mán	10
Tiefenbach	tífen-bach	10
Wesselényi	veselényi	10
Belgioioso	beldzsojózó	10
Cagliostro	káj-josztró	10
Canterbury	kenterbörri	10
Cumberland	kámbörlend	10
Escorialba	eszkoriálba	10
Gregoriana	gregoriáná	10
Hargreaves	hárgrívsz	10
Herbeville	herbe-vill	10
Hispaniola	hiszpánióla	10
Hradzsinba	hra-dzsinba	10
Institutio	insztitúció	10
James Cook	dzsémsz kúk	10
James Watt	dzsémsz vatt	10
Kahlenberg	kálen-berg	10
Kosciuszko	kosz-sziuszkó	10
Martinuzzi	mártinudzzi	10
Maupertois	mópörtoá	10
Melanchton	melánk-ton	10
Pragmatica	pragma-tika	10
Regensburg	régensz-burg	10
Roggendorf	rógen-dorf	10
Savonarola	szavonaróla	10
Settlement	szetölment	10
Valladolid	vélléndolid	10
Versailles	verszáj	10
Wittenberg	vitten-berg	10
Argentínát	argen-tínát	10
Austriának	ausztriának	10
Barcelonát	barszelónát	10
Sanctiónak	szankciónak	10
Servetónak	szervetónak	10
Wesselényi	vesh-shelényi	10
Aehrenthal	érentál	10
Austerlitz	aushterlitz	10
Benningsen	beningszen	10
Bernadotte	bernádotté	10
Clemenceau	klemenszó	10
Cordeliers	kordölijé	10
Desmoulins	démulan	10
Felix Díaz	féliksz diáz	10
Georgicont	geor-gikont	10
Hansemannt	hánsze-mánnt	10
Kellermann	keller-mann	10
Kremsierbe	kremzírbe	10
Kuomintang	kuo-mint-áng	10
Laibachban	láj-bach-ban	10
Louisianát	lujzijánát	10
Memorandum	memo-randum	10
Metternich	metter-nih	10
Montmartre	mónmárt	10
Nesselrode	nesz-szelród	10
Notre-Dame	not-re dám	10
Novibazari	novi bázári	10
Odesszában	odesszában	10
Saint-Just	szen-zsüszt	10
Salzburgot	záltz-burgot	10
Schlieffen	shlífen	10
Schmerling	shmerling	10
Talleyrand	tálerán	10
Tegetthoff	tegett-hoff	10
Treitschke	trejcske	10
Wellington	vellington	10
Zollverein	tzollferájn	10
Augusztus	augusztus	9
Damjanich	damjanics	9
Ferabosco	ferráboszkó	9
Jellasics	jelashics	9
Karlovics	kárlovics	9
Monarchia	monarhia	9
Querlonde	kverlón	9
Sisatovac	shishatovács	9
Strahurai	shtra-hurai	9
Borgiaról	bordzsáról	9
Caprarára	káprárára	9
Genovában	dzsenovában	9
Genovából	dzsenovából	9
Alleghany	aligeni	9
Amsterdam	amszterdam	9
Antwerpen	ant-verpen	9
Aurangzeb	áurángzeb	9
Condillac	kondiják	9
Condorcet	kondorszet	9
Francisco	fránsziszkó	9
Glinszkij	glínszkíj	9
Guanahani	guánáháni	9
Haireddin	heredin	9
Helvetius	helvéciusz	9
Jefferson	dzsefferzon	9
Kollonich	kollonics	9
Landriano	lándriánó	9
Louisiana	lújzijáná	9
Luxemburg	luxem-burg	9
Marmontel	mármontel	9
Mazzarini	mádzzáríni	9
Militaire	militer	9
Orsinikat	orszínikat	9
Pompadour	pomp-ádúr	9
Potsdamba	potsz-dámba	9
Raffaello	raffa-elló	9
Ravaillac	rávejják	9
Richardot	ricsárdot	9
Richelieu	rishe-lijő	9
Rotterdam	rotter-dám	9
Sebastian	szebásztián	9
Speyerben	szpejerben	9
Strafford	sztráf-fórd	9
Struensee	sztrűenzé	9
Toussaint	tüszen	9
Veteranit	veteránit	9
Dumarsais	dümárszez	9
Elcanóval	elkánóval	9
Hercegség	her-cegség	9
Mihállyal	mihájjal	9
Sevillába	szevíjjába	9
Stanzákat	sztancákat	9
Virginiát	virdzsíniát	9
Algeciras	álheszírász	9
Auerstadt	au-ersh-tátt	9
Benedetti	Benedetti	9
Bonaparte	bonápár-te	9
Cavaignac	kávennyák	9
Dembinski	dembinszki	9
Dessewffy	dezsőfi	9
Dublinban	dáblinban	9
Dumouriez	dümurijé	9
Déroulede	deruled	9
Feuerbach	fójer-bach	9
Fouchéval	foshéval	9
Francisco	fránsziszkó	9
Friedland	frídlend	9
Garibaldi	gari-baldi	9
Genovával	dzsenovával	9
Gladstone	glád-sztón	9
Heckenast	hkknászt	9
Huertának	uertának	9
Josephine	zsozefin	9
Kasgáriát	kászgáriját	9
Kropotkin	kropot-kin	9
Königlich	kőnig-lich	9
Bizottság	bizott-shág	9
Kütahyába	kütáhijába	9
Lafayette	lafajet	9
Lagardell	lögárdöl	9
Lamartine	lömártín	9
Lansdowne	lándszdáun	9
Lombardia	lombar-dia	9
Garibaldi	gari-baldi	9
Mauritius	maurítziusz	9
Mussolini	musz-szolíni	9
Nietzsche	nícse	9
Obrenovic	obrenovics	9
Peschiera	peszkijerrá	9
Reichsrat	rejsz-rát	9
Reichstag	rejsz-tág	9
Rhodesiát	rodéziát	9
Saarlouis	szárlujísz	9
Salisbury	szálsz-börri	9
Savoyáért	Szavojáért	9
Seychelle	szeshell	9
Solferino	szolferínó	9
Toscanába	toszkánába	9
Transvaal	transzvál	9
Vaucanson	vokánszon	9
Wenckheim	venk-hejm	9
Anonymus	ano-nímusz	8
Berczely	ber-tzeli	8
Brigetio	brigettió	8
Dregheol	dreg-eol	8
Eberhard	éber-hárt	8
Habsburg	habsz-burg	8
Ippolito	ippolitó	8
Pannonia	pannónia	8
Sobieski	szobijeszki	8
Terbosco	ter-boszkó	8
Générale	zsenerál	8
Soklyósy	sokjósi	8
Waterloo	vaterló	8
Baselben	bázelben	8
Bastille	básztíj	8
Bramante	brá-mánt	8
Ceylonba	szejlonba	8
Cromwell	krómvell	8
Delaware	deláver	8
Fernando	fernándó	8
Friedell	fridel	8
Habsburg	habsz-burg	8
Jurisics	yurishics	8
Kamakura	kama-kura	8
Leonardo	leonárdó	8
Liangsan	lijáng-szán	8
Lilburne	lil-börn	8
Maryland	merilend	8
Montcalm	món-kálm	8
Olivarez	oli-várez	8
Pamplona	pamplóna	8
Paraguay	párágváj	8
Piacenza	pijászendzá	8
Poitiers	poá-tyijé	8
Pugacsov	puga-csov	8
Quebecet	kübeket	8
Rochelle	roshell	8
Rousseau	rusz-szó	8
Schwendi	shvendi	8
Sobieski	szobijeszki	8
Solymost	sojmosht	8
Sujszkij	szújszkíj	8
Victoria	viktória	8
Voltaire	vol-ter	8
Welserek	velzerek	8
Zamojski	zámojszki	8
Zamoyski	zámojszki	8
Colonnák	kolonnák	8
Lodovico	lodovíkó	8
Mühlberg	műl-berg	8
Salzburg	záltz-burg	8
Sanctiót	szankciót	8
Sanlúcar	szánlúkár	8
Siegbert	zígbert	8
Vespucci	veszpuccsi	8
Virginia	virdzsínia	8
Albrecht	álbrecht	8
Badenben	bádenben	8
Belcredi	belkredi	8
Bernardo	bernárdó	8
Bernhard	bernárd	8
Bordeaux	bordó	8
Carranza	kárándzá	8
Cisalpin	szizelpán	8
Commerce	komersz	8
Concorde	konkord	8
Cádizban	kádisz	8
Delcassé	delkászé	8
Disraeli	dizráeli	8
Domingue	dománg	8
Ecuadort	ekvádort	8
Gioberti	dzsoberti	8
Giolitti	dzsolitti	8
Gothában	gotában	8
Guyanába	gvájánába	8
Générale	zsénérál	8
Hausmann	hausz-mann	8
Jelasics	jelashics	8
Jemappes	zsömáp	8
Kansasba	kenzeszbe	8
Karolina	karo-lina	8
Lachaise	lás-ez	8
Landerer	lan-derer	8
Landwehr	lánd-ver	8
Lassalle	lászál	8
Lissánál	lizzánál	8
Marchand	márshan	8
Missouri	misz-szurri	8
Monarchi	monarhi	8
Moniteur	monitőr	8
Napoleon	napóleon	8
National	neshönel	8
Navarino	návárrínó	8
Nebraska	nebraszka	8
Nedeczky	nedetzki	8
Ostennek	ósztennek	8
Paraguay	párágváj	8
Pesztyel	pesz-tyel	8
Polignac	polignátz	8
Radetzky	rádetzki	8
Rauscher	ros-er	8
Rhodésia	rodézia	8
Richmond	ricsmond	8
Sevirjov	szevirjov	8
Sinopnál	szinopnál	8
Stefánia	shtefánia	8
Taglalat	taglalat	8
Tecumseh	tekumszeh	8
Theobald	tiobáld	8
Todleben	todl-ben	8
Veracruz	verákrúz	8
Verseghy	versegi	8
Villának	víjjának	8
Vukovics	vukovics	8
Walewska	válevszka	8
Walewski	válevszki	8
Waterloo	vaterló	8
Atlamos	atlamosz	7
Balling	bálling	7
Brudern	brúdern	7
Caprara	káprárá	7
Dragoly	dragoj	7
Egressy	eg-resi	7
Erazmus	erázmusz	7
Genfben	genf-ben	7
Heisler	hájz-ler	7
Heister	hájsz-ter	7
Kelemen	kel-emen	7
Komarno	komárnó	7
Kossuth	kosút	7
Lambert	lámbert	7
Mekcsey	mekcsei	7
Omoneus	omoneusz	7
Sanyiki	shanyiki	7
Steindl	shtejdl	7
Teuffel	tójfel	7
Ungaria	ungárija	7
Varkoch	var-kocs	7
Wilhelm	vilhelm	7
Bocskay	bocskai	7
Béthune	bétún	7
Csórich	csórics	7
Március	március	7
Ottavio	ottávió	7
Thököly	tököli	7
Farnese	fárnéze	7
Amerika	ame-rika	7
Asikaga	ashi-kaga	7
Austria	auszt-rija	7
Barcsay	bar-csai	7
Beatrix	beátriksz	7
Bourbon	búrbon	7
Busbeck	bushbekk	7
Calonne	kálonn	7
Canossa	kanossza	7
Cocceji	kocsedzsi	7
Coligny	kolinyi	7
Cranmer	kránmer	7
Diderot	didró	7
England	inglend	7
Eperjes	eper-jes	7
Farnese	fárnéze	7
Fayette	fájett	7
Fergana	fergáná	7
Georgia	dzsordzsa	7
Gergely	ger-gej	7
Germain	zsörmen	7
Giorgio	dzsordzsó	7
Granada	gránádá	7
Hampden	hempdön	7
Heister	hájsztör	7
Holbach	hol-bach	7
Ibrahim	ibrahim	7
Iejaszu	iejaszu	7
Kalikut	kali-kut	7
Lehmann	léman	7
Louvois	lövoá	7
Lyonban	lijonban	7
Macaura	mákura	7
Malabar	málábár	7
Marston	mársztón	7
Matthys	mátísz	7
Mazarin	mázárin	7
Mekcsey	mekcsei	7
Mercier	mörszijé	7
Mettrie	metrijé	7
Ontario	ontárió	7
Orinoco	ori-nokó	7
Padilla	pádíjja	7
Partium	partzijum	7
Perouse	peröüz	7
Plassey	plász-szi	7
Quesnay	kesznai	7
Rabutin	rabutyin	7
Reniger	reny-ijé	7
Rhodosz	rodosz	7
Sanctio	szanktzió	7
Sennyei	seny-nyei	7
Sidonia	szidónia	7
Sixtusi	sziksztuszi	7
Steuben	shtójben	7
Swieten	shvíten	7
Toscana	toszkána	7
Walpole	válpól	7
Zeeland	zéland	7
Baleári	bále-ári	7
Borgiák	bordzsák	7
Erasmus	erászmusz	7
Chiléig	csíléig	7
Münnich	mün-ich	7
Münster	mün-szter	7
Niccoló	nikkoló	7
Orléans	orleán	7
Sforzák	szfortzák	7
Thököly	tököli	7
Tiziano	titziánó	7
Toscaná	toszkáná	7
William	vilijem	7
Yucatán	jukatán	7
Álvares	álvárez	7
Aladdin	ala-din	7
Antonio	antónió	7
Apponyi	aponyi	7
Atacama	atakama	7
Bazaine	bázen	7
Blanqui	blánk	7
Blücher	blücher	7
Boulang	bölanzs	7
Canning	kening	7
Caprivi	káprivi	7
Csemegi	csem-egi	7
Daimler	dájmler	7
Dickens	dikensz	7
Diploma	dip-loma	7
Dreyfus	drejfusz	7
Dreyser	drejzer	7
Décazes	dékáz	7
England	inglend	7
Eugénie	özseni	7
Firenze	fire-nze	7
Frankel	frenkel	7
Galilei	gali-lei	7
Gironde	zsirond	7
Houston	hjú-szton	7
Lamberg	lám-berg	7
Landtag	lándtág	7
Lincoln	linkoln	7
Magenta	mag-enta	7
Mainban	májnban	7
Mantova	man-tova	7
Mazzini	máddzíni	7
Medzsid	medzsid	7
Meidzsi	mejidzsi	7
Montijo	montihó	7
Novarum	novárum	7
Ohranát	oranát	7
Palacky	palatzki	7
Panther	pánter	7
Quebeck	kübek	7
Réforme	réform	7
Schlick	shlikk	7
Sherman	shörmen	7
Somsich	szomis	7
Stefanó	sztefánó	7
Taaffét	táffét	7
Travail	trávéjl	7
Vetsera	vecsera	7
Villele	vilel	7
Amtman	amt-mán	6
Bakich	bákikh	6
Banque	bánk	6
Cavour	kávör	6
Ceczey	cetzei	6
Decius	detziusz	6
Ehenyk	ehenik	6
Frantz	frántz	6
Giskra	gishkra	6
Haynau	haj-nau	6
Lantos	lan-tos	6
Lenkey	lenkei	6
Mehmed	meh-med	6
Nostra	nosztra	6
Ocskay	ocskai	6
Sixtus	sziksztusz	6
Stella	sztellá	6
Stibor	shtibor	6
Mehmed	meh-med	6
Tenkes	ten-kes	6
Teufel	tójfel	6
Ursula	urszula	6
Valide	válíd	6
Vedano	vedánó	6
Wathay	vatai	6
Zalasd	zalashd	6
Zimony	zimony	6
Aeneás	éne-ász	6
Görgey	görgei	6
Széchy	szécsi	6
Akbart	ákb-árt	6
Ancien	ánszijen	6
Aranda	árándá	6
Armada	arm-ada	6
Bahama	bah-ama	6
Balogh	balog	6
Bercis	berszí	6
Boleyn	bolejn	6
Carlos	kárlosz	6
Cateau	sháto	6
Corpus	korpusz	6
Crespy	kreszpi	6
Diuban	győben	6
Dubois	düboá	6
Elcano	elkánó	6
Fleury	flöri	6
Fronde	frond	6
Fugger	fug-ger	6
Genova	dzsenova	6
Ghiraj	giráj	6
Ghyczy	gitzi	6
Gritti	grit-ti	6
Herder	her-der	6
Hosius	hósziusz	6
Howard	háoárd	6
Hudson	hádzön	6
Hurrem	hur-rem	6
Jersey	dzsörzi	6
Lantos	lantos	6
Lefort	löfort	6
Loyola	lojola	6
Luther	lúter	6
Madame	mádám	6
Manche	máncs	6
Medina	med-ina	6
Mehmed	meh-med	6
Modena	mo-dena	6
Mozart	mótzárt	6
Necker	nek-ker	6
Niklas	nikász	6
Ocskay	ocskai	6
Oppeln	ópeln	6
Peking	pek-ing	6
Pertav	pertav	6
Pombal	pom-bál	6
Rights	rájtsz	6
Savoya	szavoja	6
Sophie	szofí	6
Stuart	sztúárt	6
Mehmed	meh-med	6
Toledo	toledó	6
Turgot	turgó	6
Valois	váloá	6
Wolsey	vúlzi	6
Wyclif	víkliff	6
Bastát	básztát	6
Cesare	csezáre	6
Ceutát	tzeutát	6
Chilét	csílét	6
Habeas	hábe-ász	6
Juntát	huntát	6
Münzer	müntzer	6
Régime	rézsím	6
Savoyá	szavojá	6
Tadeus	tádeusz	6
Charta	karta	6
Andrew	endrú	6
Augusz	augusz	6
Babeuf	báböff	6
Barras	bárá	6
Bombay	bombéj	6
Caesar	tzézár	6
Canada	kanada	6
Carnot	kárnó	6
Ceylon	szejlon	6
Ciprus	tziprush	6
Conrad	konrád	6
Crispi	kriszpi	6
Custoz	kusztodz	6
Daniel	denijel	6
Emsben	emszben	6
Engels	eng-elsz	6
Fashod	feshőd	6
Helvét	helvét	6
Hentzi	hentzi	6
Herzen	hertzen	6
Huerta	uertá	6
Monroe	monró	6
Jenner	dzsenör	6
Julius	dzsúliusz	6
Juárez	huárez	6
Kempen	kem-pen	6
Krüger	krűger	6
Kübeck	kübek	6
George	dzsordzs	6
Lónyay	lónyai	6
Maupas	mopá	6
Mekkát	mek-kát	6
Monroe	monró	6
Máltát	máltát	6
Nelson	nelzon	6
Oranje	oranzs	6
Oregon	ore-gon	6
Orsova	orszova	6
Parmát	pármát	6
Paulus	pau-lusz	6
Paxton	pákszton	6
Philip	filip	6
Périer	périjé	6
Sadowa	szadova	6
Taaffe	táffe	6
Thiers	tírsz	6
Thugut	tugut	6
Vetter	vet-ter	6
Zapata	szápátá	6
Bánffy	bánfi 	6
Balogh	balog	6
Anjou	anzsú	5
Babat	bab-at	5
Bagni	bányi	5
Basta	básztá	5
Bereg	ber-eg	5
Bodor	bod-or	5
Cecey	cetzei	5
Donch	doncs	5
Egert	e-gert	5
Guido	gujdó	5
Guthi	gúti	5
Guyon	guj-on	5
Helfy	helfi	5
Ketel	ketel	5
Khuen	qen	5
Mertz	merrtz	5
Mikus	mik-ush	5
Piust	piuszt	5
Savoi	szavoj	5
Simor	shi-mor	5
Thaly	táli	5
Urban	urbán	5
Zichy	zicsi	5
Lugos	lúgos	5
Révay	rávai	5
Adolf	a-dolf	5
Anjou	anzsú	5
Balti	bal-ti	5
Basta	básztá	5
Bihar	bih-ar	5
Blois	bloá	5
Conti	konti	5
Diane	diján	5
Doria	dorijá	5
Ernst	ern-szt	5
Globe	glób	5
Guise	gíz	5
Hoorn	hórn	5
Jovan	jován	5
Kleve	kléve	5
Kuang	kuáng	5
Locke	lokk	5
Loire	loár	5
Mahal	má-hál	5
Mekka	mek-ka	5
Model	mo-del	5
Morus	mórusz	5
Paine	pen	5
Palos	pálosz	5
Pavia	pávia	5
Peres	presz	5
Pinta	pintá	5
Santa	szántá	5
Simon	shi-mon	5
Sully	száli	5
Temes	temesh	5
Tower	táoör	5
Tudor	tyúdor	5
Tycho	ticsó	5
Vasco	vászkó	5
Vassy	vásszi	5
Volga	vol-ga	5
Yuste	zsüszt	5
Colón	kolón	5
Condé	kondé	5
Kjóto	kjó-tó	5
María	máríjá	5
Mogul	mo-gul	5
Alamo	álámó	5
Albin	álbin	5
Berry	berri	5
Beust	bójszt	5
Blanc	blán	5
Burma	bur-ma	5
Bülow	büló	5
Chile	csíle	5
Civil	szivil	5
Fiume	fiu-me	5
Giers	gírsz	5
Hegel	hégel	5
Heine	hájne	5
Indus	indush	5
Davis	déjvisz	5
Josef	jo-zef	5
Kmety	kmeti	5
Louis	lují	5
Marat	márát	5
Mohan	mo-hán	5
Murat	murát	5
Natal	nátál	5
Ozora	ozo-ra	5
Rerum	rérum	5
Santa	szántá	5
Sipka	sipka	5
Sorel	szorel	5
Sucre	szukré	5
Szuez	szu-ez	5
Texas	tekszász	5
Villa	Víjja	5
Áchim	áhim	5
École	éköl	5
Arad	a-rad	4
Arte	árte	4
Bana	ba-na	4
Bars	barsh	4
Cuza	tzúza	4
Dera	de-ra	4
Egri	egri	4
Fazy	fázi	4
Husz	husz	4
Ince	intze	4
Nane	na-ne	4
Tari	ta-ri	4
Burg	burrg	4
Casa	kászá	4
Crni	tzrni	4
Diaz	diáz	4
Etat	etát	4
Gama	gám	4
Guam	guám	4
Jean	zsan	4
Juan	huán	4
Kant	kánt	4
Knox	noksz	4
Laud	laúd	4
Onaz	onász	4
Pitt	pitt	4
Prut	prút	4
Roma	róma	4
Salm	szálm	4
Sund	Zund	4
Tang	táng	4
Tata	ta-ta	4
Vasa	vaaszá	4
Vend	vend	4
Jüan	jüan	4
Yvon	ívon	4
Alit	al-it	4
Díaz	diáz	4
Elba	el-ba	4
Fezt	fetz	4
Gott	gott	4
Ioan	ioán	4
José	hozé	4
Karl	kárl	4
Otto	ottó	4
Ruhr	rúr	4
Said	szájid	4
Samu	sa-mu	4
Thun	tún	4
Zola	zóla	4
